kil	ğ’†¸
kim	ğ’¶
kin	ğ’†¥
dib2	ğ’†ª
kid	ğ’†¤
AN	ğ’€­
(asila)	ğ’‚°
kib	ğ’„’
gÃ¡b	ğ’†
be2	ğ’‰
bat,	ğ’
kit	ğ’†¤
_ugu_	ğ’Œ‹ğ’…—
gidâ‚‚	ğ’
gÃ¡l	ğ’……
gÃ¡n	ğ’ƒ·
kis	ğ’†§
Å¡Ã©k	ğ’‹ 
ta[k	ğ’‹³
nam#?	ğ’‰†
ki]	ğ’† 
ki_	ğ’† 
Å¡Ã©r	ğ’
U18	ğ’‡
U19	ğ’Œ·
tub2	ğ’‚€
{ÄiÅ¡}ÄeÅ¡tin	ğ’„‘ ğ’ƒ¾
225	ğ’— ğ’ ğ’Š
zuru5	ğ’‡²
f	ğ’Š©
903	ğ’ ğ’™ ğ’ˆ
Ã¡	ğ’€‰
268	ğ’˜ ğ’Œ‹ğ’Œ‹ ğ’
269	ğ’˜ ğ’Œ‹ğ’Œ‹ ğ’‘†
KEÅ â‚‚	ğ’†Ÿ
264	ğ’˜ ğ’Œ‹ğ’Œ‹ ğ’‰
265	ğ’˜ ğ’Œ‹ğ’Œ‹ ğ’Š
266	ğ’˜ ğ’Œ‹ğ’Œ‹ ğ’‹
267	ğ’˜ ğ’Œ‹ğ’Œ‹ ğ’Œ
260	ğ’˜ ğ’Œ‹ğ’Œ‹
261	ğ’˜ ğ’Œ‹ğ’Œ‹ ğ’¹
262	ğ’˜ ğ’Œ‹ğ’Œ‹ ğ’ˆ«
263	ğ’˜ ğ’Œ‹ğ’Œ‹ ğ’ˆ
GIR7	ğ’º
urta	ğ’…
giÅ¡gal	ğ’‡
riá¸«	ğ’ˆ›
silaâ‚„	ğ’ƒ¢
4 36	ğ’‰ ğ’Œ ğ’‹
7(disz)	ğ’Œ
zÃº	ğ’…—
(galilla)	ğ’ƒ›
Nig2	ğ’ƒ»
Te3	ğ’‰€
TIL3	ğ’‹¾
Ã d	ğ’‡¼
tiÅ¡2	ğ’Œ¨
Å ILAM	ğ’‰¦
ara3	ğ’„¯
ara2	ğ’Œ’
{d}tiszpak	ğ’€­ ğ’ˆ½
GALGA	ğ’ƒŒ
kip	ğ’„’
Gur	ğ’„¥
dalla	ğ’ˆ¦ğ’„˜ğ’ƒ¼
kir	ğ’„«
szig5	ğ’‹
{ku6}agargara	ğ’„© ğ’‰©
ESI	ğ’†—
_e2_	ğ’‚
{iri}im{ki}	ğ’Œ· ğ’… ğ’† 
lul	ğ’ˆœ
uruâ‚â‚‚	ğ’ƒ¡
DÃ€G	ğ’‰Œğ’Œ“
uruâ‚â‚†	ğ’‚—
zÃ­z	ğ’©
Å ITA	ğ’‹–
buranun	ğ’Œ“ğ’„’ğ’‰£
Ter	ğ’Œ
Ã r	ğ’„¯
 dijir	ğ’€­
DÃ€R	ğ’°
a	ğ’€€
_sa	ğ’Š“
udul6	ğ’­
silig4	ğ’‹µ
pad3	ğ’…†ğ’Š’
ambar	ğ’†¹
Ã©me	ğ’Œğ’ˆ¨
Uá¸ª	ğ’„´
ar er ir ur	ğ’…ˆ ğ’…• ğ’…• ğ’Œ¨
Ga	ğ’‚µ
(edakua2)	ğ’†º
UD@s	ğ’Œš
kurâ‚‰	ğ’†­
719	ğ’ ğ’• ğ’ ğ’‘†
Gi	ğ’„€
Å¡er11	ğ’„Šğ’‡
kiÅ¡	ğ’†§
UD@g	ğ’Œ™
TÃšL	ğ’‡¥
Gu	ğ’„–
TÃšG	ğ’Œ†
SAG@g	ğ’Š¨
2(u)	ğ’Œ‹ğ’Œ‹
mesz_	ğ’ˆ¨ğ’Œ
GA	ğ’‚µ
pa9	ğ’Š·
gaba	ğ’ƒ®
Å¡Ã©Å¡	ğ’‹
S,A	ğ’
pa7	ğ’„·
(uÅ¡6)	ğ’‰¥
129	ğ’– ğ’‘†
GU	ğ’„–
127	ğ’– ğ’Œ
hala	ğ’„¬
125	ğ’– ğ’Š
124	ğ’– ğ’‰
123	ğ’– ğ’ˆ
122	ğ’– ğ’ˆ«
121	ğ’– ğ’¹
daÄal	ğ’‚¼
gabu2	ğ’†
saga11/siga18	ğ’†¥ ğ’†¥
lib4	ğ’…†
BÃŒÅ EBA	ğ’„¡
lib2	ğ’†—
lib3	ğ’Š®
Mul	ğ’€¯
Muru2	ğ’‰ 
dadag	ğ’Œ“ğ’Œ“
(halubba)	ğ’ƒ‘
araá¸«4	ğ’‚ğ’‘ğ’ğ’•
Lugal	ğ’ˆ—
x]x	ğ’Ššğ’ƒ®
{gesz#?}tukul#?	ğ’„‘ ğ’†ª
728	ğ’ ğ’– ğ’
gum2	ğ’ˆ
KID	ğ’†¤
mesz3	ğ’ˆ©
gu(2)	ğ’ˆ« ğ’ˆ«
gab3	ğ’…˜
gab2	ğ’†
galilla	ğ’ƒ›
Å¡amaÅ¡	ğ’Œ“
gab;	ğ’ƒ®
TIK	ğ’„˜
424	ğ’› ğ’‰
TIN	ğ’·
TIM	ğ’´
TIL	ğ’Œ€
BAPPIR	ğ’‹‹
ÄœÃ	ğ’‚·
tukum	ğ’‹—ğ’ƒ»ğ’Œ‰ğ’‡²
tukul	ğ’†ª
kÃ d	ğ’†‘
_gin2	ğ’‚†
[an	ğ’€­
szutul5	ğ’Œª
szutul4	ğ’‚ˆ
GÃ	ğ’‚·
jisz	ğ’„‘
miri	ğ’‚‡
[a]	ğ’€€
ENTEN	ğ’‰‰
eb2	ğ’Œˆ
Ãºá¸«	ğ’Œ”
tÃ¹n	ğ’‚…
tÃ¹m	ğ’‰
DU@s	ğ’½
GÃš	ğ’„˜
TIr	ğ’Œ
zap2	ğ’†ª
ganun	ğ’ƒ 
ZIZ2	ğ’©
kurun	ğ’‰ğ’·
tuku5	ğ’‹³
dar3	ğ’°
GISZ2	ğ’•
408	ğ’š ğ’ ğ’
409	ğ’š ğ’ ğ’‘†
404	ğ’š ğ’ ğ’‰
405	ğ’š ğ’ ğ’Š
406	ğ’š ğ’ ğ’‹
407	ğ’š ğ’ ğ’Œ
400	ğ’š ğ’
401	ğ’š ğ’ ğ’¹
402	ğ’š ğ’ ğ’ˆ«
403	ğ’š ğ’ ğ’ˆ
Å¡	Å¡
dagal	ğ’‚¼
lÃ¬b]	ğ’Š®
xx	ğ’Ššğ’ƒ®
gal4	ğ’Š©
tugul	ğ’‰„ğ’
ZIK	ğ’¨
TI8	ğ’€‰
dul3_	ğ’Š¨
ZIB	ğ’¦
Hi	ğ’„­
ZIG	ğ’¨
ame2	ğ’ƒ£
á¹£ir	ğ’ˆ²
ÃšMBISAG	ğ’‹„
á¹­u	ğ’‚…
 kadra	ğ’ƒ»ğ’Š®ğ’€€
_dam_	ğ’®
s,ur	ğ’€«
413	ğ’š ğ’ ğ’ˆ
412	ğ’š ğ’ ğ’ˆ«
411	ğ’š ğ’ ğ’¹
410	ğ’š ğ’
417	ğ’š ğ’ ğ’Œ
416	ğ’š ğ’ ğ’‹
415	ğ’š ğ’ ğ’Š
udun	ğ’Œ‹ğ’ˆ¬
á¹£il	ğ’‰£
á¹­e	ğ’²
419	ğ’š ğ’ ğ’‘†
418	ğ’š ğ’ ğ’
á¹­a	ğ’•
udug	ğ’Œœ
lis	ğ’‡º
liq	ğ’Œ¨
SIG3	ğ’‰º
SIG4	ğ’‹
 urud	ğ’
SIG7	ğ’…Š
SIG8	ğ’ƒ°ğ’‹ºğ’„‘
liz	ğ’‡º
gada:sukkal	ğ’ƒ° ğ’ˆ›
_ukken_	ğ’Œº
lib	ğ’ˆœ
lid	ğ’€–
lik	ğ’Œ¨
lih	ğ’Œ“
lim	ğ’…†
lil	ğ’‡¸
 dumu	ğ’Œ‰
MÃ™Å 	ğ’ˆ¹
nagga	ğ’€­ğ’ˆ¾
mah_	ğ’ˆ¤
(eÅ¡emin4)	ğ’€‘
li3	ğ’…†
li2	ğ’‰Œ
ubur4	ğ’¢
<ru>	ğ’Š’
li9	ğ’‰ˆ
tÃºr	ğ’„™
li!	ğ’‡·
 uru2	ğ’
szunigin	ğ’‹—ğ’ƒ¸
GIN3	ğ’†³
tÃºg	ğ’Œ†
rig7	ğ’‰ºğ’„¸ğ’º
kiszib	ğ’ˆ©
aÅ¡+u	ğ’€¸ ğ’Œ‹
unkin	ğ’Œº
á¹­Ã¹	ğ’º
á¹­Ãº	ğ’Œ…
 Å¡ubur	ğ’‹š
ad]ad	ğ’…
á¹­Ã¬	ğ’‹¾
á¹­Ã­	ğ’„­
Å¡ubaâ‚„	ğ’ˆ¹
á¹­Ã¨	ğ’‰ˆ
ul5	ğ’‚¬
á¹­Ã 	ğ’„­
273	ğ’˜ ğ’Œ ğ’ˆ
272	ğ’˜ ğ’Œ ğ’ˆ«
271	ğ’˜ ğ’Œ ğ’¹
270	ğ’˜ ğ’Œ
i[t]	ğ’€‰
276	ğ’˜ ğ’Œ ğ’‹
275	ğ’˜ ğ’Œ ğ’Š
s,il	ğ’‰£
utua	ğ’­
ku6_	ğ’„©
279	ğ’˜ ğ’Œ ğ’‘†
278	ğ’˜ ğ’Œ ğ’
s,ir	ğ’ˆ²
ina	ğ’€¸
TUá¸ª	ğ’ƒ®
18	ğ’Œ‹ ğ’
19	ğ’Œ‹ ğ’‘†
pat	ğ’‰»
gÃ r	ğ’ƒ¼
eâ‚‚	ğ’‚
eâ‚ƒ	ğ’Œ“ğ’º
10	ğ’Œ‹
11	ğ’Œ‹ ğ’¹
12	ğ’Œ‹ ğ’ˆ«
t[a]la	ğ’Š‘
12265	ğ’¤ ğ’Ÿ ğ’˜ ğ’Œ‹ğ’Œ‹ ğ’Š
15	ğ’Œ‹ ğ’Š
16	ğ’Œ‹ ğ’‹
taraá¸«	ğ’°
ubâ‚‚	ğ’‚ 
enku	ğ’ ğ’„©
gÃ m	ğ’†›
GIM	ğ’¶
zubur	ğ’­
azlag3	ğ’„‘ğ’Œ†ğ’‰¿ğ’‹¼ğ’€€ğ’º
sikil_	ğ’‚–
azlag7	ğ’ˆ
azlag4	ğ’„‘ğ’Œ†ğ’‹¼ğ’€€ğ’º
dam2	ğ’Œ“
kir11	ğ’Š©ğ’ƒ¢
{d}esz18	ğ’€­ ğ’€¹
qum3	ğ’ˆ
zubud	ğ’„ª
s,i3	ğ’‹›
s,i2	ğ’£
Å¡Ã¨r	ğ’‚¡
[Å¡]ul	ğ’‚„
'a3	ğ’‚
ÄeÅ¡tu	ğ’‰¿
Ãºbur	ğ’¥
{urud}al	ğ’ ğ’€ 
[r]a	ğ’Š
lah2	ğ’‚Ÿ
lah3	ğ’ˆ›
szeg7	ğ’…
szeg5	ğ’‹
rap	ğ’Š
MUATI	ğ’‰º
maÅ¡	ğ’ˆ¦
MUG@g	ğ’ˆ¯
sag#	ğ’Š•
umma	ğ’„‘ğ’†µ
Å¡e12	ğ’€€ğ’ˆ¹
za ze zi zu	ğ’ ğ’£ ğ’£ ğ’ª
sag8	ğ’†—
sag9	ğ’Š·
liÅ¡	ğ’‡º
gir11	ğ’†Ÿ
IM{muÅ¡en}	ğ’… ğ’„·
zÃ á¸«	ğ’€„
sag2	ğ’‰ºğ’ƒ¶
sag3	ğ’‰º
sag4	ğ’ˆ—
sag5	ğ’‰ 
sag7	ğ’ƒ¶
303	ğ’™ ğ’ˆ
sedx(KAD3)	ğ’†‘
MES	ğ’ˆ©
{d}UTU	ğ’€­ ğ’Œ“
nam2	ğ’‰‡
Å EG6	ğ’‰ˆ
sag_	ğ’Š•
Å¡u[m	ğ’‹³
MÃ™D	ğ’‰¯
saga	ğ’Š•
gu10	ğ’ˆ¬
unu3	ğ’€–ğ’†ª
112	ğ’• ğ’ ğ’ˆ«
113	ğ’• ğ’ ğ’ˆ
110	ğ’• ğ’
111	ğ’• ğ’ ğ’¹
116	ğ’• ğ’ ğ’‹
117	ğ’• ğ’ ğ’Œ
114	ğ’• ğ’ ğ’‰
115	ğ’• ğ’ ğ’Š
118	ğ’• ğ’ ğ’
pisan	ğ’‚·
Äuâ‚â‚€	ğ’ˆ¬
mun;	ğ’µ
kalama	ğ’Œ¦
1(geÅ¡2)	ğ’•
s,u2	ğ’ª
Å¡Ã¨Ä	ğ’€€ğ’€­
DINgIR	ğ’€­
ninniâ‚…	ğ’Œƒ
imminte	ğ’…·
7	ğ’Œ
haÅ¡á¸«ur	ğ’ˆ¢
qe2	ğ’† 
kÃ¹Å¡	ğ’Œ‘
TAK4	ğ’‹º
Äarza	ğ’‰ºğ’€­
nim5	ğ’ƒ»
nim4	ğ’ˆ
Nanna	ğ’‹€ğ’† 
nim2	ğ’Š©ğ’Œ†
girum/gurum	ğ’ƒµ ğ’ƒµ
pa]l	ğ’„
aÅ¡+Å¡ur	ğ’€¸ ğ’‹©
[Å¡Ãº]	ğ’‹™
NÃDABA	ğ’‰€
_{lu2}hal_	ğ’‡½ ğ’„¬
370	ğ’š ğ’Œ‹
de6#?	ğ’º
{ÄiÅ¡}apin	ğ’„‘ ğ’€³
emengi	ğ’…¶
naszsze	ğ’€
imin2	ğ’‹°ğ’‹°ğ’‹°ğ’€¸
MUÅ &MUÅ 	ğ’ˆ¶
de3{ki}	ğ’‰ˆ ğ’† 
tul2	ğ’‡¥
zalag	ğ’Œ“
us,	ğ’Š»
(guru17)	ğ’„•
sÃ g	ğ’‰º
ia2	ğ’Š
[Å¡Ãº	ğ’‹™
 ga	ğ’‚µ
SZAH	ğ’‹š
_{gesz}tukul	ğ’„‘ ğ’†ª
us4	ğ’Š
(sil6)	ğ’‚¢
biá¹­	ğ’‚
us2	ğ’‘
azlag	ğ’Œ†ğ’Œ“
10 1:30	ğ’Œ‹ ğ’¹ ğ’Œ
ap3	ğ’€œ
ap2	ğ’€–
bu15	ğ’‰»
bu14	ğ’‡¡
1/4	ğ’‘¢
sumaÅ¡	ğ’‹¨
mal]	ğ’‚·
bar	ğ’‡
bat	ğ’
1/2	ğ’ˆ¦
1/3	ğ’‘š
KINDA	ğ’ƒ±
bak	ğ’„·
bal	ğ’„
ban	ğ’‰¼
munu3	ğ’ƒ…
bab	ğ’‰½
á¹­ar	ğ’‹»
bad	ğ’
bag	ğ’„·
{i7}buranun	ğ’€€ğ’‡‰ ğ’Œ“ğ’„’ğ’‰£
{gesz}tir	ğ’„‘ ğ’Œ
_kalam_	ğ’Œ¦
mal2	ğ’‹›ğ’€€
7200	ğ’£
 si	ğ’‹›
NÃNDA	ğ’‰’
maÅ¡kim	ğ’‰ºğ’½
en3	ğ’‡·
gÃºr	ğ’ƒµ
usz	ğ’‘
usu	ğ’€‰ğ’†—
Ã™	ğ’…‡
MU&MU	ğ’ˆ­
ba9	ğ’
Å¡Ã¡r	ğ’Š¹
(uzug3)	ğ’Œ‘ğ’Š•
ba?	ğ’€
ba3	ğ’Œ
ba2	ğ’‰º
ba5	ğ’…®
ba4	ğ’‚·
ba7	ğ’ˆ¦
ba6	ğ’Œ‘
TUr3	ğ’‰£ğ’‡¬
[kar]	ğ’‹¼ğ’€€
lut,	ğ’‚
geresz	ğ’„µ
ba!	ğ’€
munus	ğ’Š©
tuá¸«	ğ’ƒ®
á¹­a3	ğ’„­
[Å¡u	ğ’‹—
_ud5_	ğ’š
ab ib ub	ğ’€Š ğ’… ğ’Œ’
zah3	ğ’€„
kiszeg	ğ’Œ‘ğ’„‰
DU7	ğ’ŒŒ
DU6	ğ’‡¯
DU3	ğ’†•
DU2	ğ’Œ…
zabar	ğ’Œ“ğ’…—ğ’‡
_Ã¡r	ğ’Œ’
â€™	ğ’€ª
DU8	ğ’ƒ®
musz3	ğ’ˆ¹
musz2	ğ’ˆ½
musz5	ğ’‹€
 bi2	ğ’‰ˆ
{urud}a2	ğ’ ğ’€‰
EN2	ğ’‹™ğ’€­
hibis2	ğ’€¨
ÃŒTI	ğ’†œğ’Œš
(adamen2)	ğ’ˆ˜
gÃ¨Å¡tu	ğ’„‘ğ’‰¿ğ’Œ†
mitum	ğ’†ªğ’€­
DUh	ğ’ƒ®
umbisag	ğ’‹ƒ
zulumá¸«i	ğ’‹ ğ’‹¤
gag	ğ’†•
alad	ğ’†˜
DUG	ğ’‚
DUB	ğ’¾
du13	ğ’Œ‰
DUN	ğ’‚„
SUá¸ª	ğ’ˆ½
DUL	ğ’Œ‹ğ’Œ†
du15	ğ’„°
du14	ğ’ˆŒ
targul	ğ’ˆ£ğ’ˆ®
139	ğ’– ğ’Œ‹ ğ’‘†
241200	ğ’Š¹ ğ’ƒ² ğ’©
DUR	ğ’„™
Å Ã‰Å 	ğ’‹
ZABAR	ğ’Œ“ğ’…—ğ’‡
az/aza	ğ’Š ğ’Š
132	ğ’– ğ’Œ‹ ğ’ˆ«
{tug2}aktum2	ğ’Œ† ğ’‹¢ğ’€€
134	ğ’– ğ’Œ‹ ğ’‰
135	ğ’– ğ’Œ‹ ğ’Š
136	ğ’– ğ’Œ‹ ğ’‹
137	ğ’– ğ’Œ‹ ğ’Œ
zar2	ğ’‰Œ
ÄeÅ¡tug3	ğ’„‘ğ’‰¿ğ’Œ†
ÄeÅ¡tug2	ğ’„‘ğ’Œ†ğ’‰¿
Å ANABI	ğ’‘›
dabâ‚…	ğ’†ª
nunuz	ğ’‰­
MAR:APIN	ğ’ˆ¥ ğ’€³
edakua	ğ’‚¸
nanna2	ğ’€­ğ’‹€ğ’† 
DIGIR	ğ’€­
SU&SU	ğ’‹£
nunus	ğ’‰­
esza/esze4	ğ’€€ğ’Šºğ’‰ª ğ’€€ğ’Šºğ’‰ª
uâ‚„	ğ’Œ“
ka5	ğ’ˆœ
nujun	ğ’†°
9 1	ğ’‘† ğ’¹
esze2	ğ’‚ 
GIDIM	ğ’„‡
ed3	ğ’‡¯ğ’º
ed2	ğ’Œ“ğ’º
libiÅ¡	ğ’€š
ELAM	ğ’‰
ser3	ğ’‚¡
ka2	ğ’†
UMUM	ğ’Œ£
gal2_	ğ’……
468	ğ’› ğ’ ğ’
469	ğ’› ğ’ ğ’‘†
szamasz	ğ’Œ“
462	ğ’› ğ’ ğ’ˆ«
463	ğ’› ğ’ ğ’ˆ
460	ğ’› ğ’
kisim	ğ’¬
466	ğ’› ğ’ ğ’‹
467	ğ’› ğ’ ğ’Œ
464	ğ’› ğ’ ğ’‰
465	ğ’› ğ’ ğ’Š
muru9	ğ’…ğ’‚‚
usandu	ğ’„·ğ’†•
_geme2_	ğ’Š©ğ’†³
muru2	ğ’‰ 
798	ğ’ ğ’— ğ’Œ‹ ğ’
799	ğ’ ğ’— ğ’Œ‹ ğ’‘†
id6	ğ’€€ğ’‡‰ğ’ƒ²
790	ğ’ ğ’— ğ’Œ‹
791	ğ’ ğ’— ğ’Œ‹ ğ’¹
792	ğ’ ğ’— ğ’Œ‹ ğ’ˆ«
793	ğ’ ğ’— ğ’Œ‹ ğ’ˆ
794	ğ’ ğ’— ğ’Œ‹ ğ’‰
795	ğ’ ğ’— ğ’Œ‹ ğ’Š
796	ğ’ ğ’— ğ’Œ‹ ğ’‹
797	ğ’ ğ’— ğ’Œ‹ ğ’Œ
id2	ğ’€€ğ’‡‰
255	ğ’˜ ğ’Œ‹ ğ’Š
garâ‚…	ğ’ˆ–
garâ‚ƒ	ğ’ƒ¼
Å¡uhub	ğ’‹™ğ’€¯
siÅ¡kur2	ğ’€¬ğ’€¬
munsub	ğ’ˆ°
kiszib3	ğ’¾
jiri2	ğ’„ˆ
jiri3	ğ’„Š
immin	ğ’†‰
lugal#?	ğ’ˆ—
[mu]	ğ’ˆ¬
3	ğ’ˆ
 kar	ğ’‹¼ğ’€€
{d}Nammu	ğ’€­ ğ’‡‰
garaâ‚‚	ğ’‚¶
lat,	ğ’†³
{gi}ba	ğ’„€ ğ’€
arad	ğ’€´
698	ğ’ ğ’• ğ’Œ ğ’
halubba	ğ’ƒ‘
aÄarin2	ğ’€
aÄarin3	ğ’‚¼ğ’‚†
_u4_	ğ’Œ“
aÄarin4	ğ’‚¼ğ’‹†
aÄarin5	ğ’‚¼ğ’‹‹
'u3	ğ’‡†
babbar_	ğ’Œ“
20;	ğ’Œ‹ğ’Œ‹
208	ğ’— ğ’Œ‹ğ’Œ‹ ğ’
t,ar2	ğ’¯
(habrud2)	ğ’†¡
202	ğ’— ğ’Œ‹ğ’Œ‹ ğ’ˆ«
203	ğ’— ğ’Œ‹ğ’Œ‹ ğ’ˆ
200	ğ’— ğ’Œ‹ğ’Œ‹
201	ğ’— ğ’Œ‹ğ’Œ‹ ğ’¹
206	ğ’— ğ’Œ‹ğ’Œ‹ ğ’‹
207	ğ’— ğ’Œ‹ğ’Œ‹ ğ’Œ
204	ğ’— ğ’Œ‹ğ’Œ‹ ğ’‰
205	ğ’— ğ’Œ‹ğ’Œ‹ ğ’Š
Äirâ‚‚	ğ’„ˆ
Å¡utum	ğ’„€ğ’ˆ¾ğ’€Šğ’Œ‹ğ’„
{disz}asz	ğ’¹ ğ’€¸
dÃ¬lib	ğ’Š 
zÃ¬r	ğ’ˆ²
lugal_	ğ’ˆ—
251	ğ’˜ ğ’Œ‹ ğ’¹
uri	ğ’Œµ
Å¡uâ€“d	ğ’‹— ğ’€­
igi3	ğ’† ğ’Š•
aá¹­ eá¹­ iá¹­ uá¹­	ğ’€œ ğ’€‰ ğ’€‰ ğ’Œ“
eszemen	ğ’† ğ’‚Šğ’‰ˆğ’²
uru	ğ’Œ·
sirsir	ğ’
szÃ¡b	ğ’Š®
ih]	ğ’„´
PA	ğ’‰º
ASILAL	ğ’‚°
219	ğ’— ğ’Œ ğ’‘†
218	ğ’— ğ’Œ ğ’
ni?	ğ’‰Œ
_sa10_	ğ’‰š
á¹¢I	ğ’¢
211	ğ’— ğ’Œ ğ’¹
gin7	ğ’¶
ÃB	ğ’€–
212	ğ’— ğ’Œ ğ’ˆ«
ÃD	ğ’„‰
214	ğ’— ğ’Œ ğ’‰
217	ğ’— ğ’Œ ğ’Œ
ÃG	ğ’‰˜
_kiszib3	ğ’¾
suhuÅ¡	ğ’¼
ÄÃ¬r	ğ’„Š
ni#	ğ’‰Œ
ni]	ğ’‰Œ
253	ğ’˜ ğ’Œ‹ ğ’ˆ
Mi2	ğ’Š©
(Å¡embulug)	ğ’’
szudun4	ğ’‚ˆ
{iri}a	ğ’Œ· ğ’€€
ur3	ğ’ƒ¡
ur2	ğ’Œ«
Ã©sir	ğ’‡’
ur5	ğ’„¯
ur4	ğ’Œ´
an en in un	ğ’€­ ğ’‚— ğ’…” ğ’Œ¦
tusz	ğ’†ª
ERIMâ‚‚	ğ’‰ˆğ’Š’
nit	ğ’‘
guâ‚â‚€	ğ’ˆ¬
[saÄ]	ğ’Š•
niq	ğ’Š©ğ’Œ¨
NÃšMUN	ğ’¤ğ’†¸
nir	ğ’‰ª
nim	ğ’‰
nin	ğ’Š©ğ’Œ†
nik	ğ’Š©ğ’Œ¨
lugal#	ğ’ˆ—
nig	ğ’Š©ğ’Œ¨
nib	ğ’Š‹
ILIMMU4	ğ’‘ˆ
Suen	ğ’‚—ğ’ª
irigal	ğ’€
GÃ™N	ğ’¯
hulu	ğ’…†ğ’Œ¨
GÃ™B	ğ’†
kak	ğ’†•
_lu2_	ğ’‡½
kusz7	ğ’…–
eÅ¡a	ğ’€€ğ’Šºğ’‰ª
pÃ la	ğ’‰†ğ’Š©ğ’Œ†
 ni2	ğ’‰
5	ğ’Š
uri5	ğ’‹€ğ’€Š
uri3	ğ’Œ¶
uri2	ğ’‹€ğ’€•
UG5	ğ’‚¦
_buru14_	ğ’‚™
KIÅ 	ğ’†§
sajja	ğ’‹ƒ
girâ‚â‚„	ğ’„©
s,ur2	ğ’ˆ²
uszumgal	ğ’ƒ²ğ’”
hul2	ğ’„¾
i3_	ğ’‰Œ
[unu]{ki#}	ğ’€• ğ’† 
urin	ğ’Œ¶
piÅ¡	ğ’„«
 nin	ğ’Š©ğ’Œ†
gilgameÅ¡3	ğ’„‘ğ’‰ˆğ’‚µğ’ˆ©
gilgameÅ¡2	ğ’„‘ğ’‰‹ğ’‚µğ’ˆ¨ğ’Œ‹ğ’Œ‹ğ’Œ‹
geÅ¡pu	ğ’Š’
eÅ¡6	ğ’€¸ğ’€¸ğ’€¸
eÅ¡4	ğ’¹
eÅ¡5	ğ’¹ğ’¹ğ’¹
ar ir ur	ğ’…ˆ ğ’…• ğ’Œ¨
 nir	ğ’‰ª
_giri3	ğ’„Š
eÅ¡8	ğ’†œ
BANDÃ€	ğ’Œ‰
GI	ğ’„€
KAÅ 	ğ’‰
ÃÅ 	ğ’€¾
LID	ğ’€–
ÃŒMIN	ğ’‘
mul2	ğ’‹¼
AB2	ğ’€–
TUGâ‚‚	ğ’Œ†
á¸ªI	ğ’„­
urudu	ğ’
yu	ğ’‰¿
 bad3	ğ’‚¦
á¸ªA	ğ’„©
{geÅ¡}aSAL2~a	ğ’„‘ ğ’€€ğ’Œ…ğ’ƒ®ğ’‡º
saá¸«	ğ’†¤
961	ğ’ ğ’š ğ’¹
{d}SA	ğ’€­ ğ’Š“
ya	ğ’‰¿
uruda	ğ’
yi	ğ’‰¿
á¸ªU	ğ’„·
#igi#	ğ’…†
Da	ğ’•
TÃ™R	ğ’‰£ğ’‡¬
128	ğ’– ğ’
ABa	ğ’€Š
TÃ™N	ğ’‚…
TÃ™M	ğ’‰
126	ğ’– ğ’‹
szutum2	ğ’„€ğ’ˆ¾ğ’€Šğ’Œˆ
nÃºm	ğ’ˆ
Munus	ğ’Š©
{d}eresz	ğ’€­ ğ’Š©ğ’Œ†
Å¡uba2	ğ’ğ’ˆ¹
kamâ‚„	ğ’†›
Ã¡rad	ğ’€µ
DA	ğ’•
Å¡eâ‚‚â‚	ğ’„·ğ’ˆ¿
nÃ­Äin	ğ’†¸
DI	ğ’²
_nu	ğ’‰¡
DU	ğ’º
{d}urasz	ğ’€­ ğ’…
{disz}e3	ğ’¹ ğ’Œ“ğ’º
isztar	ğ’ˆ¹
GAL~a	ğ’ƒ²
GAL~b	ğ’ƒ²
Å¡abra	ğ’‰ºğ’€ 
Su	ğ’‹¢
MÃšÅ 	ğ’ˆ½
nesz	ğ’Œ‹ğ’Œ‹
Å¡itim	ğ’¶
szub5	ğ’¤ğ’†¸
á¹£[ar]	ğ’‡¡
1(asz)	ğ’€¸
dijir	ğ’€­
IDIGNA	ğ’„˜ğ’ƒ¼
479	ğ’› ğ’ ğ’‘†
478	ğ’› ğ’ ğ’
kuÅ¡u2	ğ’†µ
471	ğ’› ğ’ ğ’¹
470	ğ’› ğ’
473	ğ’› ğ’ ğ’ˆ
472	ğ’› ğ’ ğ’ˆ«
475	ğ’› ğ’ ğ’Š
474	ğ’› ğ’ ğ’‰
477	ğ’› ğ’ ğ’Œ
476	ğ’› ğ’ ğ’‹
it4	ğ’Œ“ğ’€­ğ’‹€ğ’† 
zib]	ğ’¦
BANMIN	ğ’‘
it2	ğ’€€ğ’‡‰
jarza	ğ’‰ºğ’€­
389	ğ’š ğ’Œ‹ğ’Œ‹ ğ’‘†
nak2	ğ’‰€
pi5	ğ’‰ˆ
pi4	ğ’…—
pi3	ğ’
pi2	ğ’‰
789	ğ’ ğ’— ğ’‘†
788	ğ’ ğ’— ğ’
787	ğ’ ğ’— ğ’Œ
786	ğ’ ğ’— ğ’‹
785	ğ’ ğ’— ğ’Š
784	ğ’ ğ’— ğ’‰
783	ğ’ ğ’— ğ’ˆ
782	ğ’ ğ’— ğ’ˆ«
781	ğ’ ğ’— ğ’¹
urud	ğ’
SIG	ğ’‹
SIM	ğ’‹†
SIN	ğ’Œ
(tidnum)	ğ’Š
nagar	ğ’‰„
NINDA	ğ’ƒ»
sur3	ğ’„®
sur2	ğ’Š¨
uszum	ğ’”
(tibir2)	ğ’‹·
quâ‚‚	ğ’†ª
sur9	ğ’‹ª
itu	ğ’Œ—
pid	ğ’‚
zipah	ğ’ˆ¦
lÃ¡m	ğ’‰ˆ
uru3	ğ’Œ¶
pin	ğ’€³
pil	ğ’‰ˆ
pik	ğ’‹
ÄÃ¡	ğ’‚·
uru5	ğ’‹½
uru4	ğ’€³
pit	ğ’‚
pir	ğ’Œ“
ten2	ğ’·
384	ğ’š ğ’Œ‹ğ’Œ‹ ğ’‰
iti	ğ’Œ—
 eme3	ğ’Š©ğ’€²
DÃ™	ğ’†•
MÃ‰GIDDA	ğ’‹°ğ’†²
_un_	ğ’Œ¦
Å UN	ğ’Š¿
Å UM	ğ’‹³
Å UL	ğ’‚„
Å UB	ğ’Š’
1027	ğ’ ğ’› ğ’Œ
Å UD	ğ’‹¤
szusz2	ğ’‹™
szusz3	ğ’…–
Å UR	ğ’‹©
umbisag2	ğ’‹„
BARAG	ğ’ˆ
sÃ­skur	ğ’€¬ğ’€¬
u8	ğ’‡‡
saâ‚‰	ğ’ˆ¦
zabalam	ğ’ğ’ˆ½ğ’€•
szip	ğ’ˆ¨
 je26	ğ’‚·
Inim	ğ’…—
saâ‚‚	ğ’²
866	ğ’ ğ’˜ ğ’Œ‹ğ’Œ‹ ğ’‹
867	ğ’ ğ’˜ ğ’Œ‹ğ’Œ‹ ğ’Œ
864	ğ’ ğ’˜ ğ’Œ‹ğ’Œ‹ ğ’‰
865	ğ’ ğ’˜ ğ’Œ‹ğ’Œ‹ ğ’Š
862	ğ’ ğ’˜ ğ’Œ‹ğ’Œ‹ ğ’ˆ«
863	ğ’ ğ’˜ ğ’Œ‹ğ’Œ‹ ğ’ˆ
860	ğ’ ğ’˜ ğ’Œ‹ğ’Œ‹
861	ğ’ ğ’˜ ğ’Œ‹ğ’Œ‹ ğ’¹
sila11	ğ’‹ƒ
buranuna	ğ’Œ“ğ’„’ğ’‰£
868	ğ’ ğ’˜ ğ’Œ‹ğ’Œ‹ ğ’
869	ğ’ ğ’˜ ğ’Œ‹ğ’Œ‹ ğ’‘†
se	ğ’‹›
sa	ğ’Š“
si	ğ’‹›
su	ğ’‹¢
sz	Å¡
Å E10	ğ’†ª
aÅ¡â‚‚	ğ’€¾
855	ğ’ ğ’˜ ğ’Œ‹ ğ’Š
kinda	ğ’ƒ±
sikil	ğ’‚–
{dug}ban3	ğ’‚ ğ’Œ‰
ÃRAD	ğ’€µ
zabala2	ğ’ğ’ˆ¹ğ’€•
niÄin	ğ’†¸ğ’†¸
zabala4	ğ’ˆ¹ğ’ğ’€•
qa2	ğ’‚µ
esirâ‚„	ğ’„ƒ
dul]	ğ’Œ‹ğ’Œ†
{disz}{d}suen	ğ’¹ ğ’€­ ğ’‚—ğ’ª
esirâ‚‚	ğ’‡’
GU4	ğ’„
pirij+	ğ’ŠŠ
GU7	ğ’…¥
nibru!	ğ’‚—ğ’†¤
ÃMIN	ğ’‹°ğ’‹°ğ’‹°ğ’€¸
GU3	ğ’…—
MUNUS	ğ’Š©
Å¡e22	ğ’‚
{a}ah	ğ’€€ ğ’„´
sin2	ğ’‰†
de2	ğ’Œ¤
 a	ğ’€€
daÅ¡	ğ’Œ¨
ru6	ğ’‚”
GU4(BI)	ğ’‰
nigar	ğ’Œ‹ğ’Œ“ğ’†¤
ru3	ğ’€¸
ru2	ğ’†•
(emedub)	ğ’ƒ†
Ã‰SAG	ğ’ƒ¥
ru9	ğ’Œ·
has,	ğ’‹»
21000	ğ’§ ğ’¢
gun5	ğ’ˆ
gun4	ğ’€•
gun3	ğ’¯
gun2	ğ’„˜
ru#	ğ’Š’
DAGAL	ğ’‚¼
nigir2	ğ’‚ˆ
ussu	ğ’
lu	ğ’‡»
qar	ğ’ƒ¼
qap	ğ’ƒ®
qaq	ğ’†•
giÅ¡ha	ğ’‚·ğ’„‘
sÃ¡	ğ’²
sÃ¬	ğ’‹§
sÃ­	ğ’£
sÃ¨	ğ’‹§
idigna	ğ’„˜ğ’ƒ¼
qab	ğ’ƒ®
Å¡]u	ğ’‹—
[g]i	ğ’„€
qad	ğ’‹—
_ARAD2_	ğ’€µ
KÃ	ğ’†
sÃº	ğ’ª
qal	ğ’ƒ²
qam	ğ’ƒµ
akszak	ğ’Œ”
456	ğ’› ğ’Œ ğ’‹
455	ğ’› ğ’Œ ğ’Š
454	ğ’› ğ’Œ ğ’‰
453	ğ’› ğ’Œ ğ’ˆ
452	ğ’› ğ’Œ ğ’ˆ«
451	ğ’› ğ’Œ ğ’¹
450	ğ’› ğ’Œ
Äe26	ğ’‚·
GUR	ğ’„¥
458	ğ’› ğ’Œ ğ’
GUL	ğ’„¢
GUM	ğ’„£
GUN	ğ’„˜ğ’Œ¦
ud/u4	ğ’Œ“ ğ’Œ“
 5	ğ’Š
aba4	ğ’€•
rum	ğ’€¸
GUG	ğ’ğ’„¢
zimbir	ğ’Œ“ğ’„’ğ’‰£
ruk	ğ’Š¿
ua	ğ’‡‡
gÃ­d	ğ’
Å¡a]	ğ’Š­
Äar]	ğ’ƒ»
gÃ­l	ğ’†¸
[A]	ğ’€€
gÃ­n	ğ’‚†
maszda	ğ’ˆ¦ğ’†•
Å¡eÅ¡â‚‚	ğ’‹
5 a	ğ’Š ğ’€€
â€˜u3	ğ’‡†
bÃ©	ğ’‰
gÃ­r	ğ’„ˆ
ADDA	ğ’‡¿
(adamen)	ğ’ˆ“
un	ğ’Œ¦
reme	ğ’†¸
babila{ki}	ğ’…—ğ’€­ ğ’† 
PÃ€	ğ’…†ğ’Š’
edakua2	ğ’†º
bÃ­	ğ’‰ˆ
Å UÅ 	ğ’Œ‹
GU%GU	ğ’„—
Ã™SAN	ğ’‰®
ku14	ğ’†²
bAla	ğ’„
ku12	ğ’–
an]	ğ’€­
ku10	ğ’ˆª
ku11	ğ’† 
Å¡emeÅ¡al	ğ’‹‘
baneÅ¡	ğ’€¾
jal2	ğ’……
{d}en	ğ’€­ ğ’‚—
GESZTUG	ğ’‰¿
tag4	ğ’‹º
82	ğ’• ğ’Œ‹ğ’Œ‹ ğ’ˆ«
gir7	ğ’º
bÃ¡ra	ğ’ˆ
gir5	ğ’½
gir4	ğ’Œ‹ğ’€œ
gir3	ğ’„Š
gir2	ğ’„ˆ
i[Å¡	ğ’…–
dEN	ğ’·
megidda	ğ’‹°ğ’‹¾
bahar3	ğ’Œ‹ğ’‚”
bahar2	ğ’ƒ
hÃºl	ğ’„¾
Ã™SSU	ğ’‘…
{d}e2	ğ’€­ ğ’‚
sze{muszen}	ğ’Šº ğ’„·
ÃºkuÅ¡	ğ’„¾
{d}e4	ğ’€­ ğ’€€
lagasz	ğ’‰¢ğ’“ğ’†·
220	ğ’— ğ’
221	ğ’— ğ’ ğ’¹
222	ğ’— ğ’ ğ’ˆ«
223	ğ’— ğ’ ğ’ˆ
224	ğ’— ğ’ ğ’‰
ganzer	ğ’…†ğ’†³ğ’
226	ğ’— ğ’ ğ’‹
227	ğ’— ğ’ ğ’Œ
228	ğ’— ğ’ ğ’
229	ğ’— ğ’ ğ’‘†
ITU	ğ’Œ—
alan	ğ’€©
u_	ğ’Œ‹
ugâ‚„	ğ’Œ“
absin3	ğ’€³
ginâ‚†	ğ’„€
2(disz)?	ğ’ˆ«
kankal	ğ’† ğ’†—
kankan	ğ’†
ram;	ğ’‰˜
ITI	ğ’Œ—
KUR2	ğ’‰½
da]	ğ’•
dab	ğ’³
uzug3	ğ’Œ‘ğ’Š•
uzug2	ğ’Œ‘ğ’…—
dag	ğ’–
szup	ğ’Š’
szur	ğ’‹©
dak	ğ’–
GAL:TUK	ğ’ƒ² ğ’Œ‡
dah	ğ’ˆ­
ar3	ğ’„¯
ARARMA	ğ’Œ“ğ’€•
dam	ğ’®
dal	ğ’Š‘
dar	ğ’¯
daq	ğ’–
dap	ğ’³
szub	ğ’Š’
szum	ğ’‹³
szul	ğ’‚„
szun	ğ’Š¿
guruszta	ğ’†¯
szuk	ğ’‰»
temen	ğ’‹¼
esir	ğ’€€ğ’‡’
Tin	ğ’·
_dumu	ğ’Œ‰
DU@g	ğ’¼
ubudili	ğ’‰
bugin3	ğ’‡˜
nigin6	ğ’€
szu4	ğ’Œ‹
nigin4	ğ’Œ‹ğ’Œ“
nigin2	ğ’†¸
nigin3	ğ’Œ‹ğ’Œ“ğ’†¤
szu3	ğ’‚ 
Å UD;	ğ’‹¤
da3	ğ’†•
da2	ğ’‹«
da6	ğ’‹³
szu#	ğ’‹—
BABBAR	ğ’Œ“
AB	ğ’€Š
ra	ğ’Š
LUM	ğ’ˆ
LUL	ğ’ˆœ
re	ğ’Š‘
kar2	ğ’ƒ¸
ri	ğ’Š‘
AD	ğ’€œ
aq eq iq uq	ğ’€ ğ’…… ğ’…… ğ’ŠŒ
GESZTU	ğ’‰¿
Å¡u!	ğ’‹—
sukux(SUKUD)	ğ’ƒ´
ma]	ğ’ˆ 
ru	ğ’Š’
keÅ¡da;	ğ’†Ÿ
qat2	ğ’‹—ğ’ˆ«
AG	ğ’€
Å¡u2	ğ’‹™
qat6	ğ’†
daá¸«;	ğ’ˆ­
Å Ã€KIR	ğ’Œ¼
hibira	ğ’€¤
mam	ğ’Œ‹ğ’Œ‹
pat,	ğ’‰»
Äiskim	ğ’…†ğ’¾
mah	ğ’ˆ¤
 lul	ğ’ˆœ
mad	ğ’†³
munzur	ğ’† ğ’€­ğ’‹€ğ’† 
GABURRA	ğ’ƒ‚
GAKKUL	ğ’Œ‹ğ’µ
pat2	ğ’
mar	ğ’ˆ¥
mas	ğ’ˆ¦
zu2#	ğ’…—
Å¡un	ğ’Š¿
ESIR	ğ’€€ğ’‡’
Å¡ul	ğ’‚„
Å¡um	ğ’‹³
kur9	ğ’†­
tilâ‚ƒ	ğ’‹¾
Å¡ub	ğ’Š’
PIRIG	ğ’ŠŠ
ga6	ğ’…
Å¡ur	ğ’‹©
szed7	ğ’ˆ»
Å¡up	ğ’Š’
lisin	ğ’‰ˆğ’‹œ
na en ni un	ğ’ˆ¾ ğ’‚— ğ’‰Œ ğ’Œ¦
agar3	ğ’†»
dugâ‚ƒ	ğ’„­
agar2	ğ’‡‹
ma#	ğ’ˆ 
Ã­	ğ’Š
875	ğ’ ğ’˜ ğ’Œ ğ’Š
874	ğ’ ğ’˜ ğ’Œ ğ’‰
877	ğ’ ğ’˜ ğ’Œ ğ’Œ
876	ğ’ ğ’˜ ğ’Œ ğ’‹
871	ğ’ ğ’˜ ğ’Œ ğ’¹
870	ğ’ ğ’˜ ğ’Œ
873	ğ’ ğ’˜ ğ’Œ ğ’ˆ
 lu2	ğ’‡½
kisim3	ğ’¦
ma2	ğ’ˆ£
878	ğ’ ğ’˜ ğ’Œ ğ’
kisim7	ğ’œ
rÃ¡	ğ’º
dÃ g	ğ’‰Œğ’Œ“
nina	ğ’€
En	ğ’‚—
ag eg ig ug	ğ’€ ğ’…… ğ’…… ğ’ŠŒ
Ã©nsi	ğ’‰ºğ’‹¼ğ’‹›
rÃ¬	ğ’†¸
LIBIR	ğ’…†ğ’‚ 
Ep	ğ’…
gal_	ğ’ƒ²
maszkim2	ğ’‰ºğ’¼
6 54	ğ’‹ ğ’ ğ’‰
rÃº	ğ’†•
suhur	ğ’‹¦
ligima	ğ’…†ğ’Œ‰ğ’Œ‰
EN	ğ’‚—
707	ğ’ ğ’• ğ’ ğ’Œ
gÃ¡bu	ğ’†
GIGIR	ğ’‡€
ER	ğ’…•
AB@g	ğ’€•
kara2	ğ’ƒ¸
lidim	ğ’€¢
Å¡ibir	ğ’Œ‹ğ’‚™
kara6	ğ’„¦
saÄ5	ğ’‹ƒ
szarru	ğ’ˆ—
Å¡um2	ğ’‹§
GAÅ AN	ğ’ƒ½
_{gesz}na2_	ğ’„‘ ğ’ˆ¿
tuku4	ğ’‡§
E2	ğ’‚
E3	ğ’Œ“ğ’º
KIN	ğ’†¥
pisaj2	ğ’‹ƒ
gal!	ğ’ƒ²
{d}utu	ğ’€­ ğ’Œ“
lagasz{ki}	ğ’‰¢ğ’“ğ’†· ğ’† 
KIB	ğ’„’
m	ğ’¹
Å AG5	ğ’Š·
Å AG4	ğ’Š®
ninnu	ğ’
LIÅ 	ğ’‡º
zu:ab	ğ’ª ğ’€Š
asznan	ğ’Šºğ’Šºğ’‰ª
BÃNÅ UR	ğ’…ƒ
gal3	ğ’‡
gal2	ğ’……
gal5	ğ’‹¼
URUGAL	ğ’€
ab eb ib ub	ğ’€Š ğ’… ğ’… ğ’Œ’
sun5	ğ’”
Å¡udun	ğ’‹™
b[i	ğ’‰
BÃ€NDA	ğ’Œ‰
amalu	ğ’‚¼ğ’€­ğ’ˆ¹
sidug	ğ’‡‚
pÃºÅ¡	ğ’‰½ğ’„¬
b[a	ğ’€
 munus	ğ’Š©
ri]	ğ’Š‘
rib	ğ’†—
GIL	ğ’„ƒ
rid	ğ’ˆ©
GIN	ğ’º
buluÄâ‚ƒ	ğ’‰½ğ’‰½
rik	ğ’‹†
rim	ğ’†¸
GIG	ğ’ˆªğ’‰­
riq	ğ’‹†
ris	ğ’Š•
lu2_	ğ’‡½
GI_	ğ’„€
435	ğ’› ğ’Œ‹ ğ’Š
GIR	ğ’„«
DUG3	ğ’„­
mu7	ğ’…²
3(barig)	ğ’‘—
dÃ¬m	ğ’ˆ•
lu2#	ğ’‡½
{geÅ¡}ASAL2	ğ’„‘ ğ’€€ğ’Œ…ğ’ƒ®ğ’‡º
Å¡agan	ğ’Œ‹ğ’ƒ¶
Å¡uÅ¡	ğ’Œ‹
Ã¡[Å¡]	ğ’€¾
PI	ğ’‰¿
SIKI	ğ’‹ 
Å¡udu3	ğ’†ƒ
dÃ¬r	ğ’€­
DIMSAR	ğ’…‰
GI4	ğ’„„
gu7(KA)	ğ’…—
GI6	ğ’ˆª
GI7	ğ’‚ 
e2#	ğ’‚
[d]	ğ’€­
gurâ‚â‚€	ğ’†¥
576	ğ’ ğ’Œ ğ’‹
szah2	ğ’‚„
szubur	ğ’‹š
(banlimmu)	ğ’€¾ğ’Œ‹
ri3	ğ’†¸
ri2	ğ’Œ·
ri8	ğ’ˆ¸
ÄiÅ¡gal	ğ’‡
ri>	ğ’Š‘
dagan	ğ’† ğ’‡
EÅ 	ğ’Œ
uzug5	ğ’†ˆ
ukkin	ğ’Œº
Å¡]am	ğ’Œ‘
utu	ğ’Œ“
ah eh ih uh	ğ’„´ ğ’„´ ğ’„´ ğ’„´
eÄer	ğ’‚•
MASZ2	ğ’ˆ§
ibira	ğ’…ª
(bara9)	ğ’‡—
NUNUZ	ğ’‰­
236	ğ’— ğ’ ğ’‹
235	ğ’— ğ’ ğ’Š
234	ğ’— ğ’ ğ’‰
233	ğ’— ğ’ ğ’ˆ
232	ğ’— ğ’ ğ’ˆ«
231	ğ’— ğ’ ğ’¹
230	ğ’— ğ’
â¸¢ENâ¸£	ğ’‚—
LIBIÅ 	ğ’€š
239	ğ’— ğ’ ğ’‘†
238	ğ’— ğ’ ğ’
<u>	ğ’Œ‹
gisz	ğ’„‘
ut,	ğ’Œ“
gÃ¬r	ğ’„Š
ZIN	ğ’Š¿
Ã¬simu	ğ’Œ‹ğ’€œ
{kuÅ¡}a	ğ’‹¢ ğ’€€
paá¹­	ğ’‰»
gÃ¬n	ğ’†³
â¸¢ANâ¸£	ğ’€­
Ã‰MEÅ 	ğ’‰Š
LIM	ğ’…†
LIL	ğ’‡¸
GU4!(BI)	ğ’‰
EDIN	ğ’‚”
he2	ğ’ƒ¶
{kuÅ¡}E	ğ’‹¢ ğ’‚Š
ESIR2	ğ’‡’
addu2	ğ’Œ‘ğ’„‰
uri5{ki}	ğ’‹€ğ’€Š ğ’† 
ÄÃ¨Å¡tu	ğ’„‘ğ’‰¿ğ’Œ†
sÃ­g+aÅ¡	ğ’‹ ğ’€¾
ij3	ğ’‰˜
gur11	ğ’‚µ
gur10	ğ’†¥
gur17	ğ’„•
bahar	ğ’„
ansze	ğ’€²
 unug	ğ’€•
695	ğ’ ğ’• ğ’Œ ğ’Š
694	ğ’ ğ’• ğ’Œ ğ’‰
697	ğ’ ğ’• ğ’Œ ğ’Œ
696	ğ’ ğ’• ğ’Œ ğ’‹
691	ğ’ ğ’• ğ’Œ ğ’¹
690	ğ’ ğ’• ğ’Œ
693	ğ’ ğ’• ğ’Œ ğ’ˆ
692	ğ’ ğ’• ğ’Œ ğ’ˆ«
egi	ğ’‚ 
699	ğ’ ğ’• ğ’Œ ğ’‘†
muh2	ğ’Šš
Ã™R	ğ’ƒ¡
á¸«aÅ¡	ğ’‹»
Ã™Z	ğ’š
BU:PA	ğ’ ğ’‰º
gesztin	ğ’ƒ¾
MUÅ EN	ğ’„·
eg2	ğ’‚Š
eg3	ğ’‰˜
usu3	ğ’œ
adamin4	ğ’‰«
adamin5	ğ’‚›
adamin2	ğ’ˆ˜
adamin3	ğ’„’
KIMIN	ğ’† ğ’ˆ«
{d}a	ğ’€­ ğ’€€
GARIM	ğ’‡‘
mug	ğ’ˆ®
MEZE	ğ’€™
5000	ğ’Š¹ ğ’Ÿ ğ’— ğ’Œ‹ğ’Œ‹
limmu	ğ’¼
716	ğ’ ğ’• ğ’ ğ’‹
MA2	ğ’ˆ£
Ã©	ğ’‚
kisz	ğ’†§
RÃš	ğ’†•
Ir3	ğ’€´
udul	ğ’€–ğ’†ª
taskarin	ğ’Œ†
á¹£ib	ğ’¦
(Å¡uÅ¡6)	ğ’‡ 
aga2	ğ’‰˜
aga3	ğ’‚†
USAN3	ğ’‰®
{urud}aga	ğ’ ğ’‚‡
Ina	ğ’€¸
nigidalimmu	ğ’‰
ÄeÅ¡tin	ğ’ƒ¾
UGU2	ğ’€€ğ’…—
udub	ğ’‡›
genâ‚†	ğ’„€
ARá¸ªUÅ 	ğ’ƒ£
geÅ¡tug2	ğ’„‘ğ’Œ†ğ’‰¿
enme	ğ’‚š
MÃšNÅ UB	ğ’‹ ğ’‡´ğ’‹¦
pe2	ğ’‰
MEGIDDA	ğ’‹°ğ’‹¾
Ãºssu	ğ’‹°ğ’‹°ğ’‹°ğ’‹°
pana	ğ’‰¼
MAN	ğ’Œ‹ğ’Œ‹
ed	ğ’€‰
MAL	ğ’‚·
 ejer	ğ’‚•
[za	ğ’
MAH	ğ’ˆ¤
566	ğ’ ğ’Œ‹ğ’Œ‹ ğ’‹
rim3	ğ’‰ˆğ’Š’
rim2	ğ’€–
SIG2	ğ’‹ 
_{d}i7_	ğ’€­ ğ’€€ğ’‡‰
agam	ğ’€‚
MA_	ğ’ˆ 
GIR15	ğ’‚ 
GIR14	ğ’„©
GIR13	ğ’‹ƒ
GIR12	ğ’…”
GIR11	ğ’†Ÿ
GIR10	ğ’‰ˆ
dimâ‚‚	ğ’¶
MAR	ğ’ˆ¥
MAS	ğ’ˆ¦
MURGU	ğ’‹
SIG5	ğ’…†ğ’‚Ÿ
561	ğ’ ğ’Œ‹ğ’Œ‹ ğ’¹
munus+ma	ğ’Š© ğ’ˆ 
lit	ğ’€–
e2_	ğ’‚
GIR8	ğ’†¸
hendur	ğ’‰º
siskur	ğ’€¬
(kinda)	ğ’ƒ±
(ARAD2)	ğ’€µ
á¹­er	ğ’‹›ğ’€€
[Ã©]	ğ’‚
dirig	ğ’‹›ğ’€€
kiÅ¡i4	ğ’Š”
kiÅ¡i7	ğ’
kiÅ¡i8	ğ’
kiÅ¡i9	ğ’¬
da de di du	ğ’• ğ’² ğ’² ğ’º
EÅ 5	ğ’¹ğ’¹ğ’¹
erin	ğ’‚
erim	ğ’‚Ÿ
EÅ 6	ğ’€¸ğ’€¸ğ’€¸
569	ğ’ ğ’Œ‹ğ’Œ‹ ğ’‘†
EÅ 3	ğ’€Š
asari	ğ’‚
suá¸«3	ğ’„—
szara2	ğ’‡‹
TÃM	ğ’®
muÅ¡Å¡agana	ğ’‡š
á¸«ab	ğ’†¸
á¸«al	ğ’„¬
UGUN	ğ’Œ‹ğ’¯
Å¡eg8	ğ’‹™ğ’‰€
aÅ¡ eÅ¡ iÅ¡ uÅ¡	ğ’€¸ ğ’Œ ğ’…– ğ’‘
t,ir	ğ’‹›ğ’€€
abâ‚‚	ğ’€–
á¸«at	ğ’‰º
sir3	ğ’‚¡
AZU	ğ’¬
t,im	ğ’´
arhusz	ğ’ƒ£
USZ	ğ’‘
ENSI2	ğ’‰ºğ’‹¼ğ’‹›
[ri	ğ’Š‘
t,ib	ğ’³
eq	ğ’……
[2]	ğ’ˆ«
qÃº	ğ’†ª
Edin	ğ’‚”
Inanna	ğ’ˆ¹
Har	ğ’„¯
á¹­e4	ğ’‹¼
nuszka	ğ’‰ºğ’Œ†
ni	ğ’‰Œ
Lamma	ğ’†—
nijin	ğ’†¸ğ’†¸
qÃ©	ğ’† 
kiÅ¡ib	ğ’ˆ©
agargara	ğ’‰©
qÃ¬	ğ’„€
qÃ­	ğ’† 
mut,	ğ’„·ğ’„­
qÃ¡	ğ’‚µ
_kar	ğ’‹¼ğ’€€
Å¡Ãº]	ğ’‹™
{d}s,ar	ğ’€­ ğ’‡¡
{lu2}a	ğ’‡½ ğ’€€
ali	ğ’Œ·
t,i3	ğ’‹¾
pesz	ğ’„«
alu	ğ’Œ·
u20	ğ’Šº
[z]a	ğ’
SZE3	ğ’‚ 
_ka_	ğ’…—
PADa	ğ’‰»
(gala5)	ğ’‡
tu11+	ğ’„¸
i	ğ’„¿
gena	ğ’Œ‰ğ’¹
848	ğ’ ğ’˜ ğ’
70	ğ’• ğ’Œ‹
[Ã¹g]	ğ’Œ¦
 usu	ğ’€‰ğ’†—
urbingu	ğ’Œ©
{ÄiÅ¡}meÅ¡3	ğ’„‘ ğ’ˆ©
{disz}ha	ğ’¹ ğ’„©
duâ‚‡	ğ’ŒŒ
duâ‚†	ğ’‡¯
ENGAR	ğ’€³
duâ‚ƒ	ğ’†•
Å¡erimsur	ğ’‡œ
dugud	ğ’‚‚
duâ‚ˆ	ğ’ƒ®
su2	ğ’ª
su3	ğ’‹¤
10 1	ğ’Œ‹ ğ’¹
849	ğ’ ğ’˜ ğ’‘†
su6	ğ’…¾
su7	ğ’‡­
su8	ğ’»
845	ğ’ ğ’˜ ğ’Š
846	ğ’ ğ’˜ ğ’‹
 sag9	ğ’Š·
zilulu	ğ’‰ºğ’‡
841	ğ’ ğ’˜ ğ’¹
842	ğ’ ğ’˜ ğ’ˆ«
843	ğ’ ğ’˜ ğ’ˆ
nÃ¡	ğ’ˆ¿
RID	ğ’ˆ©
UBARA	ğ’‚¬
nÃ­	ğ’‰
nÃ¬	ğ’ƒ»
as is us	ğ’Š ğ’„‘ ğ’Š»
RIM	ğ’†¸
qu	ğ’„£
su11	ğ’…—
qi	ğ’†¥
engiz	ğ’‚—ğ’ˆ¨ğ’„€
alim	ğ’„‹
BAL	ğ’„
Ã­ti	ğ’Œ›
BAN	ğ’‰¼
qa	ğ’‹¡
BAD	ğ’
nÃº	ğ’ˆ¿
DUá¸ª;	ğ’‚ƒ
sub	ğ’…¢
sud	ğ’‹¤
sug	ğ’†¹
suh	ğ’ˆ½
Å Eb?	ğ’ˆ¨
peÅ¡	ğ’„«
suk	ğ’†¹
10 i	ğ’Œ‹ ğ’„¿
sum	ğ’‹§
sun	ğ’Œ€
sur	ğ’‹©
5(disz)	ğ’Š
Äu10	ğ’ˆ¬
{d}gesztin	ğ’€­ ğ’ƒ¾
PEÅ 	ğ’„«
á¸«ir2	ğ’„¯
SIRSIR	ğ’
kinâ‚‡	ğ’º
gana	ğ’ƒ¶
bala	ğ’„
{gisz}[tukul]	ğ’„‘ ğ’†ª
{d}Nisaba	ğ’€­ ğ’Šºğ’‰€
mim+ma	ğ’Š© ğ’ˆ 
GE23	ğ’€¹
bel2	ğ’‰‹
Å ITA3	ğ’‹¥
EZEN	ğ’‚¡
Å ITA4	ğ’Œ‹ğ’†¤
r[a]m!?	ğ’‰˜
'3	Ê¾â‚ƒ
garza2	ğ’‰ºğ’ˆ—
_mu	ğ’ˆ¬
ut	ğ’Œ“
Ã¨Ä	ğ’‰˜
zik2	ğ’‹
bal2	ğ’”
bal3	ğ’€¡
Ã¨Å¡	ğ’€Š
bal4	ğ’€¦
haszhur	ğ’ˆ¢
inda	ğ’‰’
gan#	ğ’ƒ¶
_munus_	ğ’Š©
bÃ¹lug	ğ’‰½ğ’‰½
LAá¸ª4	ğ’»
lÃ¡á¸«tan	ğ’‰¶
ji6	ğ’ˆª
laá¸«	ğ’Œ“
tÃ¡r	ğ’¯
 ih uh	ğ’„´ ğ’„´
_inim	ğ’…—
'e	ğ’€ª
JIRI3	ğ’„Š
'i	ğ’€ª
 ja2	ğ’‚·
dÃ ra	ğ’°
suá¸«;	ğ’ˆ½
511	ğ’œ ğ’Œ ğ’¹
kad3	ğ’†‘
'u	ğ’€ª
tÃ¡k	ğ’–
DISZ	ğ’¹
tÃ¡m	ğ’®
ÄÃ­r	ğ’„ˆ
szurun	ğ’‡‡
szurum	ğ’‡‡
{u2}u2#	ğ’Œ‘ ğ’Œ‘
musztu	ğ’‰¿
qi3	ğ’„€
GISZ	ğ’„‘
a e i u	ğ’€€ ğ’‚Š ğ’„¿ ğ’Œ‹
gisal	ğ’„
440	ğ’› ğ’Œ‹ğ’Œ‹
441	ğ’› ğ’Œ‹ğ’Œ‹ ğ’¹
442	ğ’› ğ’Œ‹ğ’Œ‹ ğ’ˆ«
443	ğ’› ğ’Œ‹ğ’Œ‹ ğ’ˆ
444	ğ’› ğ’Œ‹ğ’Œ‹ ğ’‰
445	ğ’› ğ’Œ‹ğ’Œ‹ ğ’Š
446	ğ’› ğ’Œ‹ğ’Œ‹ ğ’‹
447	ğ’› ğ’Œ‹ğ’Œ‹ ğ’Œ
448	ğ’› ğ’Œ‹ğ’Œ‹ ğ’
449	ğ’› ğ’Œ‹ğ’Œ‹ ğ’‘†
nitadam	ğ’Š©ğ’‘ğ’®
dag3	ğ’‰Œğ’Œ“
(uru10)	ğ’Š˜
e7	ğ’…—
bil2	ğ’‰‹
bil3	ğ’„‘ğ’‰‹
ziâ‚ƒ	ğ’¥
bil4	ğ’„‘ğ’‰ˆ
Å Aâ‚†	ğ’Š·
emeÅ¡	ğ’Š©ğ’‡¬
E	ğ’‚Š
729	ğ’ ğ’– ğ’‘†
SIKIL	ğ’‚–
keÅ¡e2]	ğ’†Ÿ
nÃ­ta	ğ’€´
_ansze_	ğ’€²
GIN2	ğ’‚†
nunuz!(TE)zabar	ğ’‹¼
giÅ¡immar;	ğ’Š·
MI	ğ’ˆª
tuÅ¡]	ğ’†ª
t[e]	ğ’‹¼
tÃºb	ğ’‚€
242	ğ’˜ ğ’ˆ«
'Ã¬	ğ’„­
ma3	ğ’‚·
nan2	ğ’‹€ğ’† 
azu	ğ’¬
pÃº	ğ’‡¥
pÃ¹	ğ’…¤
PAD3	ğ’…†ğ’Š’
 gal	ğ’ƒ²
jiÅ¡	ğ’„‘
KIÅ I9	ğ’¬
Sin	ğ’Œ
sig2	ğ’‹ 
NIR	ğ’‰ª
NIM	ğ’‰
pÃ©	ğ’‰
NIN	ğ’Š©ğ’Œ†
pÃ­	ğ’‰
esz3	ğ’€Š
esz2	ğ’‚ 
pÃ¡	ğ’€
pÃ 	ğ’…†ğ’Š’
_U	ğ’Œ‹
_ARAD2	ğ’€µ
_i	ğ’„¿
enkud	ğ’ ğ’„©
_a	ğ’€€
enkum	ğ’‚—ğ’‰½ğ’…Šğ’‰£ğ’ˆ¨ğ’‚¬
t,il	ğ’€¸
_e	ğ’‚Š
[tak	ğ’‹³
gesztu2	ğ’„‘ğ’Œ†ğ’‰¿
eri11	ğ’€•
SANGA	ğ’‹ƒ
Å¡ur3	ğ’‹“
Å¡ur2	ğ’Š¨
_u	ğ’Œ‹
szesz2	ğ’‹
uru18	ğ’Œ¸
al3	ğ’ƒ·
szesz4	ğ’‚
uru12	ğ’ƒ¡
uru10	ğ’Š˜
185	ğ’— ğ’Š
uru16	ğ’‚—
_gun_	ğ’„˜ğ’Œ¦
_gesztu	ğ’‰¿
lab	ğ’†—
giszimmar	ğ’Š·
 zarah	ğ’Š•ğ’‰ºğ’†¸
as;	ğ’Š
per2	ğ’‚Ÿ
ubara	ğ’‚¬
ÃšBUR	ğ’¥
as2	ğ’€¾
as3	ğ’€¸
Å¡akir3	ğ’Œ¼
NI3	ğ’ƒ»
NI2	ğ’‰
{d}da	ğ’€­ ğ’•
as,	ğ’Š
{d}de	ğ’€­ ğ’²
u[b]	ğ’Œ’
GIÅ TA'E	ğ’Ÿ
SIGâ‚„	ğ’‹
Å¡eâ‚ƒ	ğ’‚ 
ne	ğ’‰ˆ
Zar	ğ’‡¡
dunâ‚ƒ	ğ’‚…
á¸«aÅ¡hur	ğ’ˆ¢
_Ã€	ğ’‰¿
pu	ğ’
eme4	ğ’‚¼
UR2	ğ’Œ«
eme6	ğ’€²ğ’Š©
UR5	ğ’„¯
eme3	ğ’Š©ğ’€²
na	ğ’ˆ¾
pa	ğ’‰º
pe	ğ’‰¿
dub	ğ’¾
abzu	ğ’ªğ’€Š
wu	ğ’‰¿
DU&DU	ğ’»
{ÄeÅ¡}apin	ğ’„‘ ğ’€³
k]i	ğ’† 
(gala4)	ğ’†½
elamkuÅ¡2	ğ’‡–
BANEÅ 	ğ’€¾
Inana	ğ’ˆ¹
dum	ğ’Œˆ
is5	ğ’Œ
{tug2}dara4	ğ’Œ† ğ’±
utul5	ğ’Ÿ
utul2	ğ’„°
{tug2}dara2	ğ’Œ† ğ’…
nijir	ğ’‚‡
277	ğ’˜ ğ’Œ ğ’Œ
niÅ¡2	ğ’„‘
qÃ¨	ğ’„€
z[u	ğ’ª
Å¡ilig	ğ’‚
GIBILâ‚†	ğ’‰ˆğ’„€
gesztug2	ğ’„‘ğ’Œ†ğ’‰¿
URI	ğ’Œµ
274	ğ’˜ ğ’Œ ğ’‰
ÄÃ¡l	ğ’……
853	ğ’ ğ’˜ ğ’Œ‹ ğ’ˆ
kaÅ¡3	ğ’’
geÅ¡tu	ğ’‰¿
850	ğ’ ğ’˜ ğ’Œ‹
857	ğ’ ğ’˜ ğ’Œ‹ ğ’Œ
856	ğ’ ğ’˜ ğ’Œ‹ ğ’‹
kaÅ¡4	ğ’½
854	ğ’ ğ’˜ ğ’Œ‹ ğ’‰
859	ğ’ ğ’˜ ğ’Œ‹ ğ’‘†
858	ğ’ ğ’˜ ğ’Œ‹ ğ’
k]u	ğ’†ª
umuÅ¡	ğ’Œ†
_iri_	ğ’Œ·
dulâ‚ƒ	ğ’Š¨
AZAG	ğ’†¬ğ’€­
dulâ‚…	ğ’Œ†
basz	ğ’ˆ¦
á¹­iÅ¡	ğ’¹
muá¸«	ğ’Œ‹ğ’…—
lak	ğ’‹ƒ
pala	ğ’‰†ğ’ˆ—
lah	ğ’Œ“
lam	ğ’‡´
lal	ğ’‡²
LAK490	ğ’”Š
{d}gibil6	ğ’€­ ğ’‰ˆğ’„€
lag	ğ’‹ƒ
ir7	ğ’†œ
ir6	ğ’€…
pa10	ğ’…†
ir3	ğ’€´
ir2	ğ’€€ğ’…†
lar	ğ’‰º
laq	ğ’‹ƒ
lap	ğ’†—
[u4	ğ’Œ“
ir9	ğ’„Š
lat	ğ’†³
dub#	ğ’¾
(sil7)	ğ’‚£
656	ğ’ ğ’ ğ’‹
DÃˆ	ğ’‰ˆ
KISIM5&KISIM5	ğ’†©
dub2	ğ’‚€
NINNU	ğ’
pirig3	ğ’ŠŒ
bara4	ğ’
325	ğ’™ ğ’Œ‹ğ’Œ‹ ğ’Š
324	ğ’™ ğ’Œ‹ğ’Œ‹ ğ’‰
327	ğ’™ ğ’Œ‹ğ’Œ‹ ğ’Œ
326	ğ’™ ğ’Œ‹ğ’Œ‹ ğ’‹
321	ğ’™ ğ’Œ‹ğ’Œ‹ ğ’¹
gaszan	ğ’ƒ½
323	ğ’™ ğ’Œ‹ğ’Œ‹ ğ’ˆ
322	ğ’™ ğ’Œ‹ğ’Œ‹ ğ’ˆ«
la#	ğ’†·
329	ğ’™ ğ’Œ‹ğ’Œ‹ ğ’‘†
328	ğ’™ ğ’Œ‹ğ’Œ‹ ğ’
iri	ğ’Œ·
bulug3	ğ’‰½ğ’‰½
szal2	ğ’‹¡
AMAR	ğ’€«
(hibira)	ğ’€¤
la3	ğ’‰¡
la2	ğ’‡²
abulla	ğ’†ğ’ƒ²
la6	ğ’†—
Ã©Å¡	ğ’‚ 
dilim2	ğ’‡º
lunga	ğ’‹†
dilim5	ğ’‡…
karadin3	ğ’Š½
karadin2	ğ’Š¼
527	ğ’œ ğ’ ğ’Œ
t,i2	ğ’„­
ukken	ğ’Œº
ÄuÅ¡ur	ğ’ƒ¡
zabala	ğ’ğ’ˆ½ğ’€•
s,al	ğ’‰Œ
s,ar	ğ’‡¡
s,ap	ğ’‚Ÿ
da#	ğ’•
[m]a!	ğ’ˆ 
ILLAT	ğ’†œğ’†³
sig17_	ğ’„€
ama	ğ’‚¼
]d	ğ’€­
ku[n?	ğ’†²
_an_	ğ’€­
muati	ğ’‰º
teÅ¡2	ğ’Œ¨
Å AGAN	ğ’Œ‹ğ’ƒ¶
INIM	ğ’…—
Å¡egâ‚‰	ğ’Š¾
13	ğ’Œ‹ ğ’ˆ
_iti_	ğ’Œ—
gÃ©me	ğ’Š©ğ’†³
14	ğ’Œ‹ ğ’‰
arhuÅ¡	ğ’ƒ£
Å¡Ã m	ğ’‰“
MUÅ 	ğ’ˆ²
_en_	ğ’‚—
AÅ DAR	ğ’Œ‹ğ’¯
ruâ‚â‚‚	ğ’‚—
mesz	ğ’ˆ¨ğ’Œ
puâ‚‚	ğ’‡¥
17	ğ’Œ‹ ğ’Œ
rah2	ğ’Š
<i>	ğ’„¿
naâ‚„	ğ’‰Œğ’Œ“
(lidim)	ğ’€¢
naâ‚‚	ğ’ˆ¿
ukusz2	ğ’„¾
ganzir3	ğ’…†ğ’†³
EÅ EMIN5	ğ’‰
am6	ğ’€­
am7	ğ’‰¿
am4	ğ’ƒ˜
am3	ğ’€€ğ’€­
aÅ¡	ğ’€¸
161	ğ’– ğ’ ğ’¹
gagia	ğ’ƒ
160	ğ’– ğ’
bÃ¡	ğ’‰º
umum	ğ’Œ£
umun	ğ’Œ‹
umuh	ğ’‡¦
â¸¢nuâ¸£	ğ’‰¡
utua2	ğ’¦
Å EÅ â‚‚	ğ’‹
{disz}na	ğ’¹ ğ’ˆ¾
'i3	ğ’„­
EN@EN	ğ’‚œ
gir2#	ğ’„ˆ
ÄeÅ¡3	ğ’‘
q[u]p	ğ’º
Å¡edur	ğ’‡¤
gissu	ğ’„‘ğ’ˆª
828	ğ’ ğ’— ğ’ ğ’
829	ğ’ ğ’— ğ’ ğ’‘†
{na4}nunuz	ğ’‰Œğ’Œ“ ğ’‰­
822	ğ’ ğ’— ğ’ ğ’ˆ«
823	ğ’ ğ’— ğ’ ğ’ˆ
820	ğ’ ğ’— ğ’
821	ğ’ ğ’— ğ’ ğ’¹
gaburra	ğ’ƒ‚
827	ğ’ ğ’— ğ’ ğ’Œ
824	ğ’ ğ’— ğ’ ğ’‰
825	ğ’ ğ’— ğ’ ğ’Š
(gurun)	ğ’„§
azlag2	ğ’Œ†
1 9	ğ’¹ ğ’‘†
GAR3	ğ’ƒ¼
88	ğ’• ğ’Œ‹ğ’Œ‹ ğ’
Unug	ğ’€•
ÃˆRIM	ğ’Œ¿
Å¡urun3	ğ’‡†
DÃLIB	ğ’†‚
du3{muszen}	ğ’†• ğ’„·
DIMâ‚‚	ğ’¶
jisal	ğ’„
{d}En	ğ’€­ ğ’‚—
DÃLIM	ğ’‡º
(gud2)	ğ’Š¥
lim2	ğ’‡¹
za[k	ğ’ 
GÃ€R	ğ’ƒ¼
lim4	ğ’‰ˆ
Å¡edu3	ğ’€†
SAG&SAG	ğ’Š§
giâ‚„	ğ’„„
UMBIN	ğ’Œ¢
Ê¾i	ğ’€ª
LUM&LUM	ğ’ˆ
mitum2	ğ’†ªğ’…‚
nesza	ğ’Œ¨ğ’ˆ¤
GÃ€M	ğ’†›
guna4	ğ’€•
{d}EN	ğ’€­ ğ’‚—
3(aÅ¡)	ğ’
zÃ¡lag	ğ’‚Ÿ
gub3	ğ’†
gub2	ğ’‡·
â¸¢biâ¸£	ğ’‰
gub5	ğ’†¤
Ã©g	ğ’‚Š
DUGUD	ğ’‚‚
1066	ğ’ ğ’› ğ’ ğ’‹
Ã©n	ğ’‹™ğ’€­
GIÅ GAL	ğ’‡
Ã©r	ğ’€€ğ’…†
Ã©s	ğ’Œ
GÃDIM	ğ’ˆ¦ğ’Œ‹
190	ğ’— ğ’Œ‹
lulim	ğ’„
QAR	ğ’ƒ¼
emeda3	ğ’ŒŸ
duda	ğ’‰ºğ’œ
SUMAÅ 	ğ’‹¨
196	ğ’— ğ’Œ‹ ğ’‹
197	ğ’— ğ’Œ‹ ğ’Œ
NIGIN	ğ’†¸ğ’†¸
Ã¹bur	ğ’¡
naÄa	ğ’‰€
kesze2	ğ’†Ÿ
guâ‚‚	ğ’„˜
guâ‚ƒ	ğ’…—
banesz	ğ’€¾
341	ğ’™ ğ’ ğ’¹
{d}pa	ğ’€­ ğ’‰º
505	ğ’œ ğ’Œ‹ğ’Œ‹ ğ’Š
504	ğ’œ ğ’Œ‹ğ’Œ‹ ğ’‰
507	ğ’œ ğ’Œ‹ğ’Œ‹ ğ’Œ
506	ğ’œ ğ’Œ‹ğ’Œ‹ ğ’‹
501	ğ’œ ğ’Œ‹ğ’Œ‹ ğ’¹
500	ğ’œ ğ’Œ‹ğ’Œ‹
503	ğ’œ ğ’Œ‹ğ’Œ‹ ğ’ˆ
502	ğ’œ ğ’Œ‹ğ’Œ‹ ğ’ˆ«
509	ğ’œ ğ’Œ‹ğ’Œ‹ ğ’‘†
508	ğ’œ ğ’Œ‹ğ’Œ‹ ğ’
u18	ğ’‡
u19	ğ’Œ·
szul3	ğ’²
499	ğ’œ ğ’Œ‹ ğ’‘†
498	ğ’œ ğ’Œ‹ ğ’
SaÄ	ğ’Š•
493	ğ’œ ğ’Œ‹ ğ’ˆ
492	ğ’œ ğ’Œ‹ ğ’ˆ«
saman	ğ’‚ ğ’‹¤ğ’‰£ğ’‚ ğ’Œ…
490	ğ’œ ğ’Œ‹
497	ğ’œ ğ’Œ‹ ğ’Œ
496	ğ’œ ğ’Œ‹ ğ’‹
495	ğ’œ ğ’Œ‹ ğ’Š
494	ğ’œ ğ’Œ‹ ğ’‰
[u4]	ğ’Œ“
lem4	ğ’‰ˆ
(ad6)	ğ’‡¿
á¸ªA@g	ğ’„«
{d}pap	ğ’€­ ğ’‰½
MÃšNSUB	ğ’‹ ğ’‡´ğ’‹¦
MURUB4	ğ’‰ 
SILA	ğ’‹»
931	ğ’ ğ’™ ğ’Œ ğ’¹
eÄ3	ğ’‰˜
5/6	ğ’‘›
azalag	ğ’Œ†ğ’Œ“
LiÅ¡	ğ’‡º
meÅ¡	ğ’ˆ¨ğ’Œ
(gahili)	ğ’ƒ”
'a4	ğ’„©
gÃ¹ru	ğ’…
Lu2	ğ’‡½
Apin	ğ’€³
(ildag2)	ğ’„Ÿ
bum	ğ’…¤
huÅ¡	ğ’„­ğ’„Š
innana	ğ’ˆ¹
ad4	ğ’
su4	ğ’‹œ
hi2	ğ’ƒ¶
Ki2	ğ’„€
ad6	ğ’‡¿
szum#	ğ’‹³
DAN	ğ’†—
844	ğ’ ğ’˜ ğ’‰
kitim	ğ’„‡
DAM	ğ’®
RI8	ğ’ˆ¸
Å AM3	ğ’‰“
mit,	ğ’
á¸ªA@t	ğ’„ª
szum3	ğ’ˆ¬
szum2	ğ’‹§
resz	ğ’Š•
847	ğ’ ğ’˜ ğ’Œ
tuku	ğ’Œ‡
karadin	ğ’Œ„
840	ğ’ ğ’˜
[m]a	ğ’ˆ 
Kib	ğ’„’
luá¸«Å¡u	ğ’„´ğ’ˆ¨ğ’Œ‹
SIL7	ğ’‚£
iq!	ğ’……
hir	ğ’†Ÿ
{d}aÅ¡nan	ğ’€­ ğ’Šºğ’Šºğ’‰ª
Kis	ğ’†§
nisz2	ğ’„‘
gidim2	ğ’ˆ¦ğ’Œ‹
engur	ğ’‡‰
rin5	ğ’ˆ•
urasz	ğ’…
wi5	ğ’„‘ğ’·
rin2	ğ’‚Ÿ
siszkur2	ğ’€¬ğ’€¬
(mur7)	ğ’ˆ±
z[a]k	ğ’ 
RUM	ğ’€¸
934	ğ’ ğ’™ ğ’Œ ğ’‰
bar2	ğ’ˆ
(arad)	ğ’€´
bar6	ğ’Œ“
bar7	ğ’‰ˆ
niÄin6	ğ’€
MAá¸ª	ğ’ˆ¤
936	ğ’ ğ’™ ğ’Œ ğ’‹
niÄin2	ğ’†¸
KÃšÅ U	ğ’†µ
937	ğ’ ğ’™ ğ’Œ ğ’Œ
guru5	ğ’€
 erin2	ğ’‚Ÿ
_abul_	ğ’†ğ’ƒ²
munus_	ğ’Š©
{lu2}as	ğ’‡½ ğ’Š
MAÅ GI	ğ’Œ
[u]k	ğ’ŠŒ
 sun7	ğ’†—
[u]l	ğ’ŒŒ
[u]m	ğ’Œ
ku[g]	ğ’†¬
NUN&NUN	ğ’‰ª
BAR	ğ’‡
12306	ğ’¤ ğ’Ÿ ğ’™ ğ’‹
bara	ğ’‡
UTUKI	ğ’™
MUSZEN	ğ’„·
{jisz}illar	ğ’„‘ ğ’Š’
GAL:muÅ¡	ğ’ƒ² ğ’ˆ²
gil3	ğ’…
gil2	ğ’†¸
ga14	ğ’…—
laá¸«tan	ğ’‰´
gudu4	ğ’„´ğ’ˆ¨
tukur2	ğ’†
niÄâ‚‚	ğ’ƒ»
 Äi6	ğ’ˆª
NIGIDAEÅ 	ğ’‘—
GIGI	ğ’„†
[za]	ğ’
barag2	ğ’–
mes	ğ’ˆ©
ID3	ğ’‡‰
mez	ğ’ˆ©
ID2	ğ’€€ğ’‡‰
med	ğ’
szU	ğ’‹—
muÅ¡2	ğ’ˆ½
Me	ğ’ˆ¨
men	ğ’ƒ
mel	ğ’…–
hur	ğ’„¯
szi	ğ’…†
diÄir	ğ’€­
sze	ğ’Šº
sza	ğ’Š­
nÃ­gin	ğ’†¸
qe	ğ’†¥
hub	ğ’„½
SZAM2	ğ’‰š
MEÅ 2	ğ’ˆ¨
szu	ğ’‹—
huj	ğ’‚ 
{d}INANNA	ğ’€­ ğ’ˆ¹
Äaâ‚‚	ğ’‚·
hun	ğ’‚ 
hum	ğ’ˆ
hul	ğ’…†ğ’Œ¨
me2	ğ’ˆª
me3	ğ’€
musz	ğ’ˆ²
me7	ğ’ƒ™
me4	ğ’
urgu2	ğ’…º
me#	ğ’ˆ¨
KÃšNGA	ğ’‹™ğ’€­
ummu	ğ’€€ğ’‚”ğ’€€ğ’‡²
Å EÅ LAM	ğ’‹‚
1110	ğ’ ğ’œ ğ’Œ
KISAL	ğ’†¦
1111	ğ’ ğ’œ ğ’Œ ğ’¹
1112	ğ’ ğ’œ ğ’Œ ğ’ˆ«
sz#	Å¡
839	ğ’ ğ’— ğ’ ğ’‘†
gir3+2	ğ’„Š ğ’ˆ«
IA9	ğ’€¼ğ’‹°
831	ğ’ ğ’— ğ’ ğ’¹
830	ğ’ ğ’— ğ’
833	ğ’ ğ’— ğ’ ğ’ˆ
832	ğ’ ğ’— ğ’ ğ’ˆ«
835	ğ’ ğ’— ğ’ ğ’Š
834	ğ’ ğ’— ğ’ ğ’‰
837	ğ’ ğ’— ğ’ ğ’Œ
836	ğ’ ğ’— ğ’ ğ’‹
ÄÃ©Å¡tu	ğ’„‘ğ’Œ†ğ’‰¿
987	ğ’ ğ’š ğ’Œ‹ğ’Œ‹ ğ’Œ
KIRI6	ğ’Š¬
nÃ¡m	ğ’‰‡
sul	ğ’‚„
GAS;	ğ’„¤
1118	ğ’ ğ’œ ğ’Œ ğ’
gÃ¡na	ğ’ƒ·
 ur2	ğ’Œ«
 ur5	ğ’„¯
MAÅ 	ğ’ˆ¦
un/Ã¹g	ğ’Œ¦ ğ’Œ¦
jar7	ğ’ˆ¥
jar8	ğ’‹
 nin9	ğ’Š©ğ’†ª
IKU	ğ’ƒ·
_ki	ğ’† 
szÃ¨	ğ’‚ 
suá¸«	ğ’ˆ½
szÃ¡	ğ’ƒ»
IA7	ğ’‹°ğ’‹°ğ’€¸
_dur	ğ’„™
nida	ğ’„˜ğ’‰­
 du14	ğ’ˆŒ
Ê¾Ã¬	ğ’„­
kir2	ğ’€š
kir7	ğ’‰‘
kir6	ğ’€˜
ban2	ğ’‘
eresz	ğ’Š©ğ’Œ†
(kunin3)	ğ’‡
zu_	ğ’ª
LILâ‚‚	ğ’†¤
SIPA	ğ’‰ºğ’‡»
687	ğ’ ğ’• ğ’Œ‹ğ’Œ‹ ğ’Œ
684	ğ’ ğ’• ğ’Œ‹ğ’Œ‹ ğ’‰
685	ğ’ ğ’• ğ’Œ‹ğ’Œ‹ ğ’Š
682	ğ’ ğ’• ğ’Œ‹ğ’Œ‹ ğ’ˆ«
683	ğ’ ğ’• ğ’Œ‹ğ’Œ‹ ğ’ˆ
680	ğ’ ğ’• ğ’Œ‹ğ’Œ‹
LIMMU4	ğ’½
ju10	ğ’ˆ¬
lil2	ğ’†¤
689	ğ’ ğ’• ğ’Œ‹ğ’Œ‹ ğ’‘†
iâ‚ƒ	ğ’‰Œ
USZ11	ğ’…œ
NAMâ‚‚	ğ’‰‡
Å¡ar2	ğ’Š¹
bu6	ğ’‡¥
BANLIMMU	ğ’€¾ğ’Œ‹
[k]a	ğ’…—
Ãº	ğ’Œ‘
SUá¸ªUR	ğ’‹¦
azag2	ğ’€‰ğ’‰º
Man	ğ’Œ‹ğ’Œ‹
290	ğ’˜ ğ’
293	ğ’˜ ğ’ ğ’ˆ
292	ğ’˜ ğ’ ğ’ˆ«
295	ğ’˜ ğ’ ğ’Š
AÊ¾	ğ’€ª
INNIN	ğ’ˆ¹
926	ğ’ ğ’™ ğ’Œ‹ğ’Œ‹ ğ’‹
299	ğ’˜ ğ’ ğ’‘†
mu	ğ’ˆ¬
Å¡Ãºtum	ğ’„€ğ’ˆ¾ğ’€Šğ’Œˆ
(Å¡ita)	ğ’‹–
mi	ğ’ˆª
Å¡ag4	ğ’Š®
Å¡ag5	ğ’Š·
me	ğ’ˆ¨
Mar	ğ’ˆ¥
ma	ğ’ˆ 
guru7_	ğ’„¦
ninta	ğ’‘
egir3	ğ’Š©ğ’‚ 
maá¹­	ğ’†³
921	ğ’ ğ’™ ğ’Œ‹ğ’Œ‹ ğ’¹
AGA3	ğ’‚†
uz3	ğ’š
enÅ¡ada	ğ’‰ºğ’Œ†
{gesz}gidri	ğ’„‘ ğ’‰º
bu;	ğ’
ummud	ğ’€€ğ’‚”ğ’‡²
kuruÅ¡da	ğ’†¯
eÅ¡21	ğ’»
NIGIN4	ğ’Œ‹ğ’Œ“
zi2	ğ’¢
NIGIN2	ğ’†¸
iszi	ğ’…–
wa+a	ğ’‰¿ ğ’€€
MUÅ â‚ƒ:EZEN	ğ’ˆ¹ ğ’‚¡
BU:nun	ğ’ ğ’‰£
sara	ğ’Š¬
 sipad	ğ’‰ºğ’‡»
uru5;	ğ’‹½
Å¡aâ‚‚	ğ’ƒ»
ma]Å¡	ğ’ˆ¦
sag10	ğ’…†ğ’‚Ÿ
sag11	ğ’†¥
LUá¸ª	ğ’ˆ›
Ã Å¡	ğ’‹
EÅ 16	ğ’º
uzu	ğ’œ
deÅ¡4	ğ’ˆ¨
 zi	ğ’£
Namma	ğ’‡‰
 za	ğ’
mÃº	ğ’Š¬
{d}dur7	ğ’€­ ğ’
[m]	ğ’¹
mÃ¬	ğ’ˆ¨
mÃ­	ğ’Š©
{d}lamma	ğ’€­ ğ’†—
mÃ¨	ğ’€
mÃ©	ğ’ˆª
mÃ¡	ğ’ˆ£
gana2	ğ’ƒ·
GÃR	ğ’‚¶
burâ‚‚	ğ’”
957	ğ’ ğ’™ ğ’ ğ’Œ
SZE	ğ’Šº
 saÄ	ğ’Š•
nigir	ğ’‚‡
taÅ¡]	ğ’Œ¨
9	ğ’‘†
GÃL	ğ’……
zu7	ğ’‚„
GÃN	ğ’ƒ·
817	ğ’ ğ’— ğ’Œ ğ’Œ
1043	ğ’ ğ’› ğ’Œ‹ğ’Œ‹ ğ’ˆ
815	ğ’ ğ’— ğ’Œ ğ’Š
1041	ğ’ ğ’› ğ’Œ‹ğ’Œ‹ ğ’¹
813	ğ’ ğ’— ğ’Œ ğ’ˆ
812	ğ’ ğ’— ğ’Œ ğ’ˆ«
1044	ğ’ ğ’› ğ’Œ‹ğ’Œ‹ ğ’‰
1045	ğ’ ğ’› ğ’Œ‹ğ’Œ‹ ğ’Š
1048	ğ’ ğ’› ğ’Œ‹ğ’Œ‹ ğ’
1049	ğ’ ğ’› ğ’Œ‹ğ’Œ‹ ğ’‘†
819	ğ’ ğ’— ğ’Œ ğ’‘†
Ã¹Å¡u	ğ’Œ
MEÅ 	ğ’ˆ¨ğ’Œ
_dingir_	ğ’€­
KALAM	ğ’Œ¦
abgal	ğ’‰£ğ’ˆ¨
Ã™RU	ğ’Œ¶
119	ğ’• ğ’ ğ’‘†
nundum	ğ’…»
kar]	ğ’‹¼ğ’€€
nundun	ğ’…»
in{ki}	ğ’…” ğ’† 
4(disz)	ğ’‰
LÃMMU	ğ’‡¹
â¸¢niâ¸£	ğ’‰Œ
_MASZ	ğ’ˆ¦
gamun	ğ’·ğ’Šºğ’‰ª
numun	ğ’†°
_sze	ğ’Šº
NINTA	ğ’‘
marduk	ğ’€«ğ’Œ“
Å¡aá¸«â‚‚	ğ’‚„
gud3	ğ’Œ‘ğ’† ğ’‹§ğ’‚µ
gud2	ğ’Š¥
_iti	ğ’Œ—
Rim	ğ’†¸
GISSU	ğ’„‘ğ’ˆª
_ma	ğ’ˆ 
_szu	ğ’‹—
WA	ğ’‰¿
gat	ğ’ƒ°
Bad	ğ’
Å¡agâ‚„	ğ’Š®
UMBISAG	ğ’‹ƒ
SANGAâ‚‚	ğ’Š«
1200	ğ’Ÿ
nig2	ğ’ƒ»
d+AG	ğ’€­ ğ’€
HUN	ğ’‚ 
Wa	ğ’‰¿
num	ğ’‰
SUHUSZ	ğ’¼
We	ğ’‰¿
gaz	ğ’„¤
SZUR	ğ’‹©
ejer	ğ’‚•
Ãºtu	ğ’Œ‹ğ’‚µ
{iri}bar	ğ’Œ· ğ’‡
523	ğ’œ ğ’ ğ’ˆ
522	ğ’œ ğ’ ğ’ˆ«
521	ğ’œ ğ’ ğ’¹
520	ğ’œ ğ’
MURUâ‚‰	ğ’…ğ’‚‚
ibâ‚‚	ğ’Œˆ
525	ğ’œ ğ’ ğ’Š
524	ğ’œ ğ’ ğ’‰
(me7)	ğ’ƒ™
(munu3)	ğ’ƒ…
529	ğ’œ ğ’ ğ’‘†
528	ğ’œ ğ’ ğ’
NUMUN	ğ’†°
ASAR	ğ’‚
isz9	ğ’‚ 
Ã m	ğ’€€ğ’€­
nigu	ğ’Šº
nu2	ğ’ˆ¿
GÃBIL	ğ’‹™ğ’€¾
isz7	ğ’€Š
[keÅ¡e2	ğ’†Ÿ
daraâ‚ƒ	ğ’°
21600	ğ’¨
nu#	ğ’‰¡
urugal	ğ’€
niga	ğ’Šº
pir2	ğ’‚Ÿ
ME3	ğ’€
HA	ğ’„©
szir3	ğ’‚¡
szir4	ğ’œ
HE	ğ’„­
pa8	ğ’‹ƒ
ga2_	ğ’‚·
pa6	ğ’‰½ğ’…–
pa5	ğ’‰½ğ’‚Š
pa4	ğ’‰½
pa3	ğ’…†ğ’Š’
pa2	ğ’€
xx;	ğ’Ššğ’ƒ®
HU	ğ’„·
Ã™BUR	ğ’¡
Ha	ğ’„©
He	ğ’„­
LAGAB+LAGAB,	ğ’†¸ğ’†¸
kar3	ğ’ƒ¼
UDUG	ğ’Œœ
Hu	ğ’„·
zip	ğ’¦
ILA2	ğ’…
mu]r	ğ’„¯
{MUNUS}al	ğ’Š© ğ’€ 
(iÅ¡huru5)	ğ’ƒ—
isib	ğ’ˆ¨
MEz	ğ’ˆ©
gurâ‚ˆ	ğ’‹½
par	ğ’Œ“
paq	ğ’„·
pap	ğ’‰½
kir13	ğ’Œ‹ğ’€œ
pan	ğ’‰¼
adamen2	ğ’ˆ˜
pal	ğ’„
pak	ğ’„·
pah	ğ’ˆœ
pag	ğ’„·
pad	ğ’‰»
pab	ğ’‰½
KUÅ U	ğ’Œ‹ğ’ŠŠ
302	ğ’™ ğ’ˆ«
301	ğ’™ ğ’¹
300	ğ’™
307	ğ’™ ğ’Œ
306	ğ’™ ğ’‹
305	ğ’™ ğ’Š
304	ğ’™ ğ’‰
Å¡eÅ¡Å¡ed	ğ’‰«
309	ğ’™ ğ’‘†
308	ğ’™ ğ’
LUGAL&LUGAL	ğ’ˆ˜
á¸ªAB	ğ’†¸
xx]	ğ’Ššğ’ƒ®
MEN	ğ’ƒ
Å¡Ã¡b	ğ’Š®
ka 	ğ’…—
_{gesz}kiri6_	ğ’„‘ ğ’Š¬
akan3	ğ’‡–
akan2	ğ’†
gina	ğ’Œ‰ğ’¹
Å¡Ã¡m	ğ’‰š
ITIMA	ğ’ƒŸ
Å¡arru	ğ’ˆ—
sahar	ğ’…–
nem	ğ’‰
IL2	ğ’…
Ã¹g!	ğ’Œ¦
LÃ™GUD	ğ’ˆŸ
336	ğ’™ ğ’Œ ğ’‹
337	ğ’™ ğ’Œ ğ’Œ
334	ğ’™ ğ’Œ ğ’‰
335	ğ’™ ğ’Œ ğ’Š
332	ğ’™ ğ’Œ ğ’ˆ«
333	ğ’™ ğ’Œ ğ’ˆ
330	ğ’™ ğ’Œ
331	ğ’™ ğ’Œ ğ’¹
kusz	ğ’‹¢
338	ğ’™ ğ’Œ ğ’
339	ğ’™ ğ’Œ ğ’‘†
ka4	ğ’‹¡
BU%BU	ğ’
uâ‚‚	ğ’Œ‘
ka3	ğ’‚µ
{d}ag	ğ’€­ ğ’€
b]al	ğ’„
unu{ki}	ğ’€• ğ’† 
HÃšL	ğ’„¾
Å¡Ã¡]	ğ’ƒ»
lÃº	ğ’‡½
KI	ğ’† 
duruâ‚…	ğ’€€
sum{sar}	ğ’‹§ ğ’Š¬
KA	ğ’…—
dumgal	ğ’‹‡
lÃ­	ğ’‰Œ
'a	ğ’€ª
lÃ©	ğ’‰Œ
gin3	ğ’†³
gin2	ğ’‚†
KU	ğ’†ª
akani	ğ’œ
gin6	ğ’„€
lÃ¡	ğ’‡²
kad	ğ’ƒ°
kab	ğ’†
Ki	ğ’† 
kal	ğ’†—
kam	ğ’„°
kan	ğ’ƒ¶
Ka	ğ’…—
kat	ğ’ƒ°
(emedub2)	ğ’ƒ§
bul5	ğ’‡¡
kap	ğ’†
kar	ğ’‹¼ğ’€€
kas	ğ’†œ
Ku	ğ’†ª
gazag	ğ’ƒœ
bÃ¡nÅ¡ur	ğ’…ƒ
der	ğ’€­
muru	ğ’„¯
jeszpa	ğ’Š’
_saga_	ğ’Š•
den	ğ’·
{iri}gu2	ğ’Œ· ğ’„˜
an#	ğ’€­
szib	ğ’ˆ¨
szid	ğ’‹ƒ
s,i	ğ’¢
szih	ğ’‹š
s,e	ğ’¢
absin	ğ’† ğ’€¸ğ’€¸
szim	ğ’‹†
szil	ğ’‹»
s,a	ğ’
szin	ğ’Š¿
sziq	ğ’‹
an2	ğ’„’
szir	ğ’‹“
szit	ğ’‹ƒ
mÃ©Å¡	ğ’ˆ¨
â¸¢kiâ¸£	ğ’† 
s,u	ğ’®
eridug{ki}	ğ’‰£ ğ’† 
Ã­ldag	ğ’„Ÿ
de6	ğ’º
de5	ğ’Š‘
dab6	ğ’
de3	ğ’‰ˆ
(zubud)	ğ’„ª
á¸ªUL	ğ’…†ğ’Œ¨
iÅ¡11	ğ’‡µ
mur7	ğ’ˆ±
(bir6)	ğ’Š¶
257	ğ’˜ ğ’Œ‹ ğ’Œ
de8	ğ’„­
256	ğ’˜ ğ’Œ‹ ğ’‹
KÃš	ğ’…¥
6(disz)	ğ’‹
li	ğ’‡·
KÃ™	ğ’†¬
aâ€“a	ğ’€€ ğ’€€
le	ğ’‡·
la	ğ’†·
250	ğ’˜ ğ’Œ‹
ana	ğ’¹
 ezem	ğ’‚¡
SILA4	ğ’ƒ¢
iaâ‚‚	ğ’Š
qin	ğ’†¥
NUN%NUN	ğ’‰«
ILIMMU	ğ’‘†
szi3	ğ’‹
szi2	ğ’‹›
szi5	ğ’†ª
anu	ğ’€­
nagal/lagal	ğ’‡¬ ğ’‡¬
[a	ğ’€€
aB	ğ’€Š
[ta]k	ğ’‹³
lama	ğ’‡´
ZAR	ğ’‡¡
sed4	ğ’ˆ¹ğ’²
gÃ©Å¡	ğ’•
GIDRU	ğ’‰º
LUGAL@LUGAL	ğ’ˆ™
geÅ¡pu2	ğ’‹—ğ’‰½ğ’‰½
ZAG	ğ’ 
umunâ‚‚	ğ’Œ£
HASZ2	ğ’¨
_im	ğ’…
gilim	ğ’„ƒ
il2_	ğ’…
ILA	ğ’€­
URIâ‚…	ğ’‹€ğ’€Š
je6	ğ’ˆª
du8!	ğ’ƒ®
Arad2	ğ’€µ
(enten)	ğ’‰‰
munÅ¡ub	ğ’ˆ°
du8;	ğ’ƒ®
kiri3	ğ’…—
kiri6	ğ’Š¬
{lu2}tur	ğ’‡½ ğ’Œ‰
rit2	ğ’‹¥
asz5	ğ’‹ ğ’‡´ğ’‹¦
asz3	ğ’‹
asz2	ğ’€¾
ulutin	ğ’† ğ’†—
 eÄer	ğ’‚•
GEszTU	ğ’‰¿
665	ğ’ ğ’• ğ’Š
Nin	ğ’Š©ğ’Œ†
kit,	ğ’†¤
hat,	ğ’‰º
rit,	ğ’ˆ©
as	ğ’Š
 mah	ğ’ˆ¤
kaÅ¡	ğ’‰
at	ğ’€œ
Uri	ğ’Œµ
kirid	ğ’†Ÿ
jen	ğ’º
Sar	ğ’Š¬
Uru	ğ’Œ·
614	ğ’ ğ’Œ‹ ğ’‰
agrig	ğ’…†ğ’¾
ZUBUR	ğ’­
[kim	ğ’¶
ej3	ğ’‰˜
szisz	ğ’‹€
610	ğ’ ğ’Œ‹
516	ğ’œ ğ’Œ ğ’‹
517	ğ’œ ğ’Œ ğ’Œ
514	ğ’œ ğ’Œ ğ’‰
515	ğ’œ ğ’Œ ğ’Š
512	ğ’œ ğ’Œ ğ’ˆ«
513	ğ’œ ğ’Œ ğ’ˆ
510	ğ’œ ğ’Œ
szullat	ğ’…‚
[mi	ğ’ˆª
612	ğ’ ğ’Œ‹ ğ’ˆ«
518	ğ’œ ğ’Œ ğ’
519	ğ’œ ğ’Œ ğ’‘†
1(gesz2)	ğ’•
agargara{ku6}	ğ’‰© ğ’„©
nijin2	ğ’†¸
484	ğ’œ ğ’‰
485	ğ’œ ğ’Š
486	ğ’œ ğ’‹
487	ğ’œ ğ’Œ
480	ğ’œ
481	ğ’œ ğ’¹
482	ğ’œ ğ’ˆ«
483	ğ’œ ğ’ˆ
kad5	ğ’†“
kad4	ğ’†’
isz	ğ’…–
uÅ¡11	ğ’…œ
488	ğ’œ ğ’
489	ğ’œ ğ’‘†
babila	ğ’…—ğ’€­
kad2	ğ’†
gen7	ğ’¶
gen6	ğ’„€
{lu2}azlag	ğ’‡½ ğ’Œ†ğ’Œ“
{d}dam	ğ’€­ ğ’®
{u2}numun2	ğ’Œ‘ ğ’¤ğ’†¸
[e]	ğ’‚Š
3(disz)_	ğ’ˆ
 ama	ğ’‚¼
ra2_	ğ’º
qer	ğ’„«
is,	ğ’„‘
KASKAL	ğ’†œ
KÃM	ğ’†š
ERâ‚‚	ğ’€€ğ’…†
is2	ğ’…–
is3	ğ’€Š
bappir3	ğ’‹
u2]	ğ’Œ‘
[du10	ğ’„­
m]a	ğ’ˆ 
lum3	ğ’‚
lum2	ğ’…†
KAB	ğ’†
piriÄâ‚ƒ	ğ’ŠŒ
KAL	ğ’†—
KAM	ğ’„°
KAN	ğ’ƒ¶
ÃŒR	ğ’€´
KAK	ğ’†•
Ãšá¸ª	ğ’Œ”
KAR	ğ’‹¼ğ’€€
KAS	ğ’†œ
ba]	ğ’€
ha+szu2	ğ’„© ğ’‹™
asilal	ğ’‚°
á¸«u	ğ’„·
ENSÃ	ğ’‰ºğ’‹¼ğ’‹›
GAszAN	ğ’ƒ½
sig17	ğ’„€
641	ğ’ ğ’ ğ’¹
_masz	ğ’ˆ¦
mud2	ğ’
1064	ğ’ ğ’› ğ’ ğ’‰
1065	ğ’ ğ’› ğ’ ğ’Š
PA:dim	ğ’‰º ğ’´
1067	ğ’ ğ’› ğ’ ğ’Œ
1060	ğ’ ğ’› ğ’
1061	ğ’ ğ’› ğ’ ğ’¹
1062	ğ’ ğ’› ğ’ ğ’ˆ«
1063	ğ’ ğ’› ğ’ ğ’ˆ
tej3	ğ’‹¼
1068	ğ’ ğ’› ğ’ ğ’
1069	ğ’ ğ’› ğ’ ğ’‘†
pa2{ki}	ğ’€ ğ’† 
minâ‚†	ğ’‹°
[Å¡ar2]	ğ’Š¹
649	ğ’ ğ’ ğ’‘†
d	ğ’€­
EREsz	ğ’Š©ğ’Œ†
u'3	ğ’‡†
adda2	ğ’‡¼
{d}nam	ğ’€­ ğ’‰†
KA5	ğ’ˆœ
sze12	ğ’€€ğ’ˆ¹
KA2	ğ’†
64800	ğ’¬ ğ’ª
dugud(LAK390)	ğ’”„
KA9	ğ’‹ƒ
DIM9	ğ’ˆ—ğ’ƒ¶
DIM8	ğ’Šğ’ƒ¶
amasz	ğ’¦
{d}dumu	ğ’€­ ğ’Œ‰
gilgamesz2	ğ’„‘ğ’‰‹ğ’‚µğ’ˆ¨ğ’Œ‹ğ’Œ‹ğ’Œ‹
zuq	ğ’†¹
zur	ğ’€«
zum	ğ’®
ka9	ğ’‹ƒ
zuh	ğ’…—
zuk	ğ’†¹
BALAG	ğ’†
366	ğ’š ğ’‹
 nij2	ğ’ƒ»
mer	ğ’‚‡
zu]	ğ’ª
bisaÄ	ğ’‚·
 gu3	ğ’…—
te	ğ’‹¼
E11	ğ’‡¯ğ’º
urdu2	ğ’€µ
lih2	ğ’‚Ÿ
lih3	ğ’ˆ›
dur10	ğ’Š¿
dur11	ğ’Œ…
szabra{ki}	ğ’‰ºğ’€  ğ’† 
dajal	ğ’‚¼
HUR	ğ’„¯
SZI	ğ’…†
dÃ¹l	ğ’Š¨
zu5	ğ’«
zu4	ğ’
gug2	ğ’ˆ–
dÃ¹g	ğ’„­
gug5	ğ’ˆ™
zu3	ğ’®
zu2	ğ’…—
á¹­am	ğ’®
nÃ¬gin	ğ’Œ‹ğ’Œ“ğ’†¤
pala3	ğ’‰†ğ’Š©ğ’Œ†
SZU	ğ’‹—
dÃ¹r	ğ’€²ğ’€´
{disz}su	ğ’¹ ğ’‹¢
zu!	ğ’ª
gÃ¬r[	ğ’„Š
HUL	ğ’…†ğ’Œ¨
tak3	ğ’‰Œğ’Œ“
UNUG	ğ’€•
á¹£um	ğ’®
 gud	ğ’„
 gub	ğ’º
aS	ğ’Š
Utu	ğ’Œ“
95	ğ’• ğ’Œ ğ’Š
Asz	ğ’€¸
henbur	ğ’†•
nisag	ğ’‰ 
Å Ã€M	ğ’‰“
nisaj	ğ’‰ 
let	ğ’€–
leq	ğ’Œ¨
lem	ğ’…†
PEÅ ;	ğ’„«
libir	ğ’…†ğ’‚ 
kÃ¬lib	ğ’†¸ğ’†¸
{d}marduk	ğ’€­ ğ’€«ğ’Œ“
re]	ğ’Š‘
parâ‚„	ğ’‰Œğ’„‘
á¸ªUM	ğ’ˆ
NAâ‚„	ğ’‰Œğ’Œ“
MUN;	ğ’µ
á¸ªUN	ğ’‚ 
{iri}eridu{ki}	ğ’Œ· ğ’‰£ ğ’† 
Qat	ğ’‹—
bah	ğ’„·
peÅ¡â‚‡	ğ’Œ‰
Å¡embi	ğ’‹
hilibu	ğ’‚Œ
peÅ¡â‚‚	ğ’‰¾
bandÃ 	ğ’Œ‰
á¸ªUB	ğ’„½
sud3	ğ’‹¢ğ’†³ğ’Š’
sud4	ğ’
(e6)	ğ’‹£
á¸ªUS	ğ’ˆ
á¸ªUR	ğ’„¯
elam	ğ’‰
<ra>	ğ’Š
ensiâ‚‚	ğ’‰ºğ’‹¼ğ’‹›
le2	ğ’‰Œ
aâ€™	ğ’€ª
NIN9	ğ’Š©ğ’†ª
sig10	ğ’‹§
aâ€“	ğ’€€
rik2	ğ’®
369	ğ’š ğ’‘†
368	ğ’š ğ’
á¹£ur	ğ’€«
nÃ­g	ğ’ƒ»
sag3#?	ğ’‰º
361	ğ’š ğ’¹
360	ğ’š
363	ğ’š ğ’ˆ
362	ğ’š ğ’ˆ«
365	ğ’š ğ’Š
364	ğ’š ğ’‰
AN&AN	ğ’€®
ZÃZ	ğ’©
mÃ¬m	ğ’Œ‹ğ’Œ‹
mÃ¬n	ğ’Œ‹ğ’Œ‹
pala2	ğ’‰†ğ’‚—
lam2	ğ’‰ˆ
lam7	ğ’‡µ
nÃ­k	ğ’ƒ»
{d}i7	ğ’€­ ğ’€€ğ’‡‰
MUNSUB	ğ’ˆ°
NINA	ğ’€
580	ğ’ ğ’
Å¡Ãºr	ğ’Š¨
genna	ğ’Œ‰ğ’¹
1/3(disz)	ğ’‘š
tan2	ğ’ƒ
tan3	ğ’ƒ©
tan6	ğ’•
s,er	ğ’ˆ²
tan4	ğ’ƒ‹
rasz	ğ’†œ
{d}sud3	ğ’€­ ğ’‹¢ğ’†³ğ’Š’
DÃM	ğ’¶
kesz2	ğ’†Ÿ
UGA2	ğ’€€ğ’…—
aia	ğ’€€ğ’€€
<ni>	ğ’‰Œ
ziz2	ğ’©
Ã©sag	ğ’ƒ¥
laá¸«4	ğ’»
LA2	ğ’‡²
(dan3)	ğ’ƒ©
TUMâ‚ƒ	ğ’‰
szu11	ğ’‹¢
LAM	ğ’‡´
LAL	ğ’‡²
aâ‚‚	ğ’€‰
aj	ğ’€
LAG	ğ’‹ƒ
bi2]	ğ’‰ˆ
gidru	ğ’‰º
pil2	ğ’‰‹
s,e2	ğ’£
ilâ‚‚	ğ’…
{d}be	ğ’€­ ğ’
 da	ğ’•
{d}ba	ğ’€­ ğ’€
neâ‚‚	ğ’‰Œ
tum/tu4	ğ’Œˆ ğ’Œˆ
 du	ğ’º
bÃ¹r	ğ’Œ‹
TIR	ğ’Œ
eÅ¡15	ğ’…–
eÅ¡16	ğ’º
bir	ğ’„µ
eÅ¡10	ğ’€€
bit	ğ’‚
aszgab	ğ’€¿
biz	ğ’‰
IRI	ğ’Œ·
URUDA	ğ’
szidim	ğ’¶
bil	ğ’‰ˆ
28800	ğ’ª
tur	ğ’Œ‰
tuq	ğ’Œ‡
tup	ğ’¾
bi]	ğ’‰
tug	ğ’Œ‡
esz#	ğ’Œ
da#?	ğ’•
tud	ğ’Œ…
banlimmu	ğ’€¾ğ’Œ‹
tub	ğ’¾
balag	ğ’†
tun	ğ’„½
balaj	ğ’†
tul	ğ’Œ‹ğ’Œ†
tuk	ğ’Œ‡
ah6	ğ’Œ”
uÅ¡umgal	ğ’ƒ²ğ’”
bi3	ğ’‰¿
bi2	ğ’‰ˆ
bi5	ğ’‰‹
rinâ‚…	ğ’ˆ•
szudu3	ğ’†ƒ
872	ğ’ ğ’˜ ğ’Œ ğ’ˆ«
muÅ¡Å¡agana2	ğ’‡
bi#	ğ’‰
eru3	ğ’ŠŸ
tug2	ğ’Œ†
[abulla	ğ’†ğ’ƒ²
tu7	ğ’„°
gim2	ğ’‚†
tu5	ğ’‹—ğ’‰€
tu4	ğ’Œˆ
tu3	ğ’º
tu2	ğ’Œ“
adab	ğ’Œ“ğ’‰£
adad	ğ’…
szem3	ğ’€š
esz8	ğ’†œ
IR3	ğ’€´
SAH4	ğ’„—
Å AR2	ğ’Š¹
t,e3	ğ’‰ˆ
á¸«e2	ğ’ƒ¶
sÃ¨g	ğ’‰º
SZA3	ğ’Š®
t,e4	ğ’‹¼
175	ğ’– ğ’ ğ’Š
800	ğ’ ğ’— ğ’Œ‹ğ’Œ‹
801	ğ’ ğ’— ğ’Œ‹ğ’Œ‹ ğ’¹
802	ğ’ ğ’— ğ’Œ‹ğ’Œ‹ ğ’ˆ«
1052	ğ’ ğ’› ğ’Œ ğ’ˆ«
SUD	ğ’‹¤
1054	ğ’ ğ’› ğ’Œ ğ’‰
806	ğ’ ğ’— ğ’Œ‹ğ’Œ‹ ğ’‹
1056	ğ’ ğ’› ğ’Œ ğ’‹
1059	ğ’ ğ’› ğ’Œ ğ’‘†
gidri_	ğ’‰º
dÃºb	ğ’‚€
DUá¸ª	ğ’‚ƒ
SUR	ğ’‹©
piriÄ	ğ’ŠŠ
pesz2	ğ’‰¾
pesz3	ğ’ˆ 
dÃºr	ğ’‚‰
NIG	ğ’Š©ğ’Œ¨
AÅ &AÅ &AÅ 	ğ’€¼
gen	ğ’º
Her	ğ’†Ÿ
sze25	ğ’†‚
sze26	ğ’…
á¸«Ã©	ğ’ƒ¶
sze20	ğ’…†
sze21	ğ’„·ğ’ˆ¿
sze22	ğ’‚
LUKUR	ğ’Š©ğ’ˆ¨
NIB	ğ’Š‹
ger	ğ’„«
{d}Gu	ğ’€­ ğ’„–
rÃ­	ğ’Œ·
Gisz	ğ’„‘
asz	ğ’€¸
M	ğ’¹
GANâ‚‚	ğ’ƒ·
d+en	ğ’€­ ğ’‚—
IÅ 	ğ’…–
IÅ¡	ğ’…–
aá¹£ eá¹£ iá¹£ uá¹£	ğ’Š ğ’„‘ ğ’„‘ ğ’Š»
Ã­limmu	ğ’‹°ğ’‹°ğ’‹°ğ’‹°ğ’€¸
ALAD	ğ’†˜
banmin	ğ’‘
ALAM	ğ’€©
NAGAR	ğ’‰„
sur11	ğ’†ª
ALAN	ğ’€©
SU4	ğ’‹œ
SU6	ğ’…¾
SU7	ğ’‡­
ge4	ğ’„„
{m}gur	ğ’¹ ğ’„¥
ge2	ğ’†¤
LU2	ğ’‡½
nidba	ğ’‰»ğ’€­ğ’ˆ¹
pisz	ğ’„«
biÅ¡	ğ’„«
el3	ğ’€­
el2	ğ’…‹
538	ğ’œ ğ’ ğ’
539	ğ’œ ğ’ ğ’‘†
534	ğ’œ ğ’ ğ’‰
535	ğ’œ ğ’ ğ’Š
536	ğ’œ ğ’ ğ’‹
537	ğ’œ ğ’ ğ’Œ
530	ğ’œ ğ’
531	ğ’œ ğ’ ğ’¹
532	ğ’œ ğ’ ğ’ˆ«
533	ğ’œ ğ’ ğ’ˆ
{ÄeÅ¡}ad	ğ’„‘ ğ’€œ
jir3	ğ’„Š
bur2	ğ’”
bur3	ğ’Œ‹
suen	ğ’‚—ğ’ª
tuÅ¡	ğ’†ª
NIGIDALIMMU	ğ’‰
GURUÅ 	ğ’„¨
IÃ	ğ’Š
kisal	ğ’†¦
as es is us	ğ’Š ğ’„‘ ğ’„‘ ğ’Š»
eli	ğ’Œ‹ğ’…—
balaÄ	ğ’†
arad2	ğ’€µ
arad3	ğ’‡µ
DUN4	ğ’‚ˆ
TA	ğ’‹«
3(asz)	ğ’
jurusz	ğ’„¨
171	ğ’– ğ’ ğ’¹
TI	ğ’‹¾
Äissu	ğ’„‘ğ’ˆª
uri2#{ki}	ğ’‹€ğ’€• ğ’† 
Tu	ğ’Œ…
zur8	ğ’Š­
NÃM	ğ’‰‡
zur2	ğ’‹ª
gur5	ğ’€
120	ğ’–
{ÄeÅ¡}a2	ğ’„‘ ğ’€‰
Ta	ğ’‹«
 kur	ğ’†³
sib2	ğ’‰ºğ’‡»
NIb	ğ’Š‹
Å¡udul;	ğ’‹™
Ti	ğ’‹¾
á¹­al	ğ’Š‘
Dan	ğ’†—
Dam	ğ’®
Å INIG	ğ’‹’
(nug2)	ğ’‹Š
Mu	ğ’ˆ¬
guru17	ğ’„•
LUGAL	ğ’ˆ—
318	ğ’™ ğ’Œ‹ ğ’
319	ğ’™ ğ’Œ‹ ğ’‘†
NIâ‚‚	ğ’‰
314	ğ’™ ğ’Œ‹ ğ’‰
315	ğ’™ ğ’Œ‹ ğ’Š
316	ğ’™ ğ’Œ‹ ğ’‹
317	ğ’™ ğ’Œ‹ ğ’Œ
garadin	ğ’Œ„
geÅ¡	ğ’„‘
lal*	ğ’‡²
313	ğ’™ ğ’Œ‹ ğ’ˆ
I2	ğ’Š
sanga6	ğ’‚µğ’ˆ£ğ’…Š
ya ye yi yu	ğ’‰¿ ğ’‰¿ ğ’‰¿ ğ’‰¿
lal2	ğ’‡³
lal3	ğ’‹­
mezej	ğ’‹„
kilim	ğ’‰¾
{d}suen	ğ’€­ ğ’‚—ğ’ª
282	ğ’˜ ğ’ ğ’ˆ«
283	ğ’˜ ğ’ ğ’ˆ
Å ÃM	ğ’‰š
281	ğ’˜ ğ’ ğ’¹
ID	ğ’€‰
kiri6_	ğ’Š¬
284	ğ’˜ ğ’ ğ’‰
Å ÃH	ğ’‚„
jidru	ğ’‰º
II	ğ’…€
288	ğ’˜ ğ’ ğ’
IK	ğ’……
IL	ğ’…‹
IM	ğ’…
IN	ğ’…”
Ã¨n	ğ’‡·
IR	ğ’…•
IS	ğ’„‘
an[a	ğ’¹
Amar	ğ’€«
(lahtan)	ğ’‰´
haÅ¡4	ğ’®
Å ÃR	ğ’Š¹
Ia	ğ’…€
pirij	ğ’ŠŠ
u2 resz	ğ’Œ‘ ğ’Š•
kasz	ğ’‰
Il	ğ’…‹
pirig	ğ’ŠŠ
Ip	ğ’…
Ir	ğ’…•
GI%GI	ğ’„ƒ
bun2	ğ’…®
apin	ğ’€³
ÄÃ­ri	ğ’„ˆ
kuâ‚…	ğ’‹»
UÅ UM	ğ’”
nibru{ki}_	ğ’‚—ğ’†¤ ğ’† 
URUDU	ğ’
MUNUS+MA	ğ’Š©ğ’ˆ 
siraraâ‚†	ğ’Œ“ğ’ˆ£ğ’€ğ’† ğ’‹³
gesztu	ğ’‰¿
zÃ Ä	ğ’‰ 
2020	ğ’  ğ’— ğ’
nindan	ğ’ƒ»
HE2	ğ’ƒ¶
du5+	ğ’‚…
Å¡akan	ğ’Œ‹ğ’ƒ¶
NITA	ğ’‘
kaskal	ğ’†œ
uszur2	ğ’‡²ğ’Š¬
kup4	ğ’†¤
ja2	ğ’‚·
IDIM	ğ’…‚
uszur4	ğ’‡²ğ’†¸
DU:EZEN	ğ’º ğ’‚¡
liá¹­	ğ’€–
girim3	ğ’€€ğ’„©ğ’‹»ğ’º
eg2/ig2	ğ’‚Š ğ’‚Š
gesztug	ğ’‰¿
asila3	ğ’‚¢
ninda2	ğ’‰’
Alam	ğ’€©
dimsar	ğ’…‰
_e4	ğ’€€
amtu	ğ’Š©ğ’†³
{d}Ã©zinu	ğ’€­ ğ’Šºğ’Šºğ’‰ª
_e2	ğ’‚
bad3	ğ’‚¦
bad5	ğ’…†
gaggim	ğ’ˆ®
tÃ©n	ğ’·
dÃ¡	ğ’‹«
dÃ 	ğ’†•
dÃ­	ğ’„­
Ã¬sz	ğ’Œ
aktum	ğ’€€ğ’‹¢
dÃ©	ğ’Œ¤
dÃ¨	ğ’‰ˆ
jar	ğ’ƒ»
tÃ©s	ğ’Œ¨
PA:URUDA	ğ’‰º ğ’
dÃº	ğ’Œ…
murgu	ğ’‹
bid	ğ’‚
LIMMU	ğ’¼
69	ğ’• ğ’‘†
68	ğ’• ğ’
n]a!?	ğ’ˆ¾
[q]is	ğ’†§
65	ğ’• ğ’Š
aÅ¡ag	ğ’ƒ·
67	ğ’• ğ’Œ
66	ğ’• ğ’‹
tarah	ğ’°
[de2	ğ’Œ¤
63	ğ’• ğ’ˆ
62	ğ’• ğ’ˆ«
bit2	ğ’
bit3	ğ’†ª
558	ğ’ ğ’Œ‹ ğ’
559	ğ’ ğ’Œ‹ ğ’‘†
en:	ğ’‚—
garasz2	ğ’† ğ’†˜
en8	ğ’Š­
552	ğ’ ğ’Œ‹ ğ’ˆ«
ANÅ E?	ğ’€²
550	ğ’ ğ’Œ‹
551	ğ’ ğ’Œ‹ ğ’¹
lipisz	ğ’€š
en2	ğ’‹™ğ’€­
554	ğ’ ğ’Œ‹ ğ’‰
555	ğ’ ğ’Œ‹ ğ’Š
TU6	ğ’…²
á¸«ul2	ğ’„¾
TU3	ğ’º
á¸«ul4	ğ’…†ğ’Œª
Å¡ita	ğ’‹–
mÃ­n	ğ’Š©
dussu	ğ’…
utulâ‚‚	ğ’„°
(banÅ¡ur2)	ğ’…ƒ
eduru	ğ’€
DUBâ‚‚	ğ’‚€
kimin	ğ’† ğ’ˆ«
TUR	ğ’Œ‰
dA	ğ’•
I	ğ’„¿
Ã¹Ä	ğ’Œ¦
TUG	ğ’Œ‡
Å¡Ã¹l	ğ’²
bitu	ğ’‚
Äalga	ğ’ƒŒ
TUM	ğ’Œˆ
DUL3	ğ’Š¨
TUK	ğ’Œ‡
EDURU	ğ’€
Å¡Ã¹d	ğ’†ƒ
de	ğ’²
da	ğ’•
ÄiÅ¡	ğ’„‘
_1(disz)	ğ’¹
t,e2	ğ’„­
di	ğ’²
sug4	ğ’‹¤
sug6	ğ’‹¢
TUb	ğ’¾
sug2	ğ’»
bit]	ğ’‚
237	ğ’— ğ’ ğ’Œ
900	ğ’ ğ’™
(bara7)	ğ’‡‹
UZU	ğ’œ
am im um	ğ’„  ğ’… ğ’Œ
adda	ğ’‡¿
tal2	ğ’‰¿
udug2	ğ’‚·ğ’„‘
anzu	ğ’€­ğ’…ğ’‚‚
kÃ¬Å¡ib	ğ’¾
{gisz}banszur	ğ’„‘ ğ’
ZUM	ğ’®
buru3	ğ’Œ‹
KUâ‚ƒ	ğ’†¬
buru7	ğ’„§
buru4	ğ’‰¢ğ’“
KUâ‚‡	ğ’†¯
imgaga3	ğ’©ğ’€­
tala	ğ’Š‘
usar3	ğ’‡³ğ’†¸
ak?	ğ’€
ÃL	ğ’…
ÃD	ğ’€€ğ’‡‰
ah3	ğ’Œ“
ÃB	ğ’Œˆ
UR3	ğ’ƒ¡
kul2	ğ’„¢
tÃ©Å¡	ğ’Œ¨
pi	ğ’‰¿
Ã¹san	ğ’‰®
szimbi	ğ’‹
Å¡em	ğ’‹†
du12	ğ’Œ‡
_sze_	ğ’Šº
tuh	ğ’ƒ®
du11	ğ’…—
du10	ğ’„­
nitah	ğ’‘
eme2	ğ’Œğ’ˆ¨
ABâ‚‚	ğ’€–
luâ‚„	ğ’ˆ
luâ‚ƒ	ğ’ˆ–
surx(ERIM)	ğ’‚Ÿ
izim	ğ’‚¡
GIBIL	ğ’‰‹
Ã¬	ğ’‰Œ
eri	ğ’Œ·
DUH	ğ’‚ƒ
bi4	ğ’
erim3	ğ’Œ¿
138	ğ’– ğ’Œ‹ ğ’
8(asz)	ğ’†
erim4	ğ’ƒ«
GÃL	ğ’†¸
GÃM	ğ’‚†
GÃN	ğ’‚†
945	ğ’ ğ’™ ğ’ ğ’Š
944	ğ’ ğ’™ ğ’ ğ’‰
szej6	ğ’‰ˆ
rÃ­n	ğ’‚Ÿ
941	ğ’ ğ’™ ğ’ ğ’¹
940	ğ’ ğ’™ ğ’
GÃR	ğ’„ˆ
942	ğ’ ğ’™ ğ’ ğ’ˆ«
978	ğ’ ğ’š ğ’Œ‹ ğ’
rÃ­g	ğ’®
mÃ­Å¡	ğ’ˆ¨ğ’Œ
949	ğ’ ğ’™ ğ’ ğ’‘†
948	ğ’ ğ’™ ğ’ ğ’
979	ğ’ ğ’š ğ’Œ‹ ğ’‘†
er3	ğ’€´
er2	ğ’€€ğ’…†
1008	ğ’ ğ’š ğ’ ğ’
er4	ğ’Œ·
1006	ğ’ ğ’š ğ’ ğ’‹
1007	ğ’ ğ’š ğ’ ğ’Œ
sukkal	ğ’ˆ›
1005	ğ’ ğ’š ğ’ ğ’Š
Å¡udâ‚ƒ	ğ’†ƒ
1003	ğ’ ğ’š ğ’ ğ’ˆ
1000	ğ’ ğ’š ğ’
1001	ğ’ ğ’š ğ’ ğ’¹
130	ğ’– ğ’Œ‹
Å¡ilam	ğ’‰¦
131	ğ’– ğ’Œ‹ ğ’¹
(umun6)	ğ’‡Š
nita2	ğ’€´
re6	ğ’º
133	ğ’– ğ’Œ‹ ğ’ˆ
me_	ğ’ˆ¨
970	ğ’ ğ’š ğ’Œ‹
_Ã­	ğ’Š
971	ğ’ ğ’š ğ’Œ‹ ğ’¹
[ma]Å¡	ğ’ˆ¦
TUÅ 	ğ’†ª
pa pe pi pu	ğ’‰º ğ’‰¿ ğ’‰¿ ğ’
ZIMBIR	ğ’Œ“ğ’„’ğ’‰£
para10	ğ’ˆ
Urudu	ğ’
1079	ğ’ ğ’› ğ’ ğ’‘†
1078	ğ’ ğ’› ğ’ ğ’
BU	ğ’
peÅ¡10	ğ’† ğ’€€
1073	ğ’ ğ’› ğ’ ğ’ˆ
1072	ğ’ ğ’› ğ’ ğ’ˆ«
1071	ğ’ ğ’› ğ’ ğ’¹
1070	ğ’ ğ’› ğ’
1077	ğ’ ğ’› ğ’ ğ’Œ
dÃ­m	ğ’¶
1075	ğ’ ğ’› ğ’ ğ’Š
1074	ğ’ ğ’› ğ’ ğ’‰
BA	ğ’€
as4	ğ’†¹
ad	ğ’€œ
BE	ğ’
BI	ğ’‰
aktum2{tug2}	ğ’‹¢ğ’€€ ğ’Œ†
HAR	ğ’„¯
{DINGIR}i7	ğ’€­ ğ’€€ğ’‡‰
me]	ğ’ˆ¨
gÃ¡	ğ’‚·
Bu	ğ’
abrig	ğ’‰£ğ’ˆ¨ğ’º
tesz2	ğ’Œ¨
gÃ¬	ğ’•
gÃ­	ğ’†¤
Ba	ğ’€
tu19	ğ’Œ‰
Be	ğ’
ANÅ E	ğ’€²
gÃº	ğ’„˜
meli2	ğ’…²
tu11	ğ’„¸
gÃ¹	ğ’…—
tu17	ğ’€€ğ’‹—ğ’‰€
tu15	ğ’…
tu6	ğ’…²
rin	ğ’†¸
elamkuÅ¡3	ğ’‡ˆ
1055	ğ’ ğ’› ğ’Œ ğ’Š
KUNGA	ğ’‹™ğ’€¯
GÃŒR	ğ’„Š
ABZU	ğ’ªğ’€Š
tehi3/tehe3	ğ’‰ ğ’‰
tisz	ğ’¹
{kuÅ¡}a2	ğ’‹¢ ğ’€‰
GÃŒM	ğ’Š©ğ’†³
iri_	ğ’Œ·
UT	ğ’Œ“
lil2{ki}	ğ’†¤ ğ’† 
UP	ğ’Œ’
UR	ğ’Œ¨
á¸ªAÅ á¸ªUR	ğ’ˆ¢
{munus}aÅ¡2	ğ’Š© ğ’€¾
UZ	ğ’Š»
UD	ğ’Œ“
UG	ğ’ŠŒ
lamma	ğ’†—
UB	ğ’Œ’
UL	ğ’ŒŒ
UM	ğ’Œ
diÅ¡	ğ’¹
BÃ	ğ’‰ˆ
ga	ğ’‚µ
kur5	ğ’‹»
Å¡e8	ğ’‹
Ur	ğ’Œ¨
ge	ğ’„€
BÃ¹	ğ’…¤
Ã¡Å¡	ğ’€¾
Sukkal	ğ’ˆ›
[gub]	ğ’º
giri3	ğ’„Š
gu	ğ’„–
Ul	ğ’ŒŒ
innin;	ğ’ˆ¹
saga11/tu9	ğ’†¥ ğ’Œ†
KISLAá¸ª	ğ’† ğ’Œ“
siâ‚„	ğ’‹œ
Å¡ennur	ğ’„’
_suhusz_	ğ’¼
[Å¡ar2	ğ’Š¹
549	ğ’ ğ’‘†
548	ğ’ ğ’
ulu3	ğ’‡
ulu2	ğ’„´ğ’ˆ¨ğ’Œ‹
Ã‰SIR	ğ’‡’
Ã¡Ä	ğ’‰˜
541	ğ’ ğ’¹
540	ğ’
543	ğ’ ğ’ˆ
542	ğ’ ğ’ˆ«
545	ğ’ ğ’Š
544	ğ’ ğ’‰
547	ğ’ ğ’Œ
546	ğ’ ğ’‹
U4	ğ’Œ“
U5	ğ’„·ğ’‹›
U6	ğ’…†ğ’‚
U2	ğ’Œ‘
U3	ğ’…‡
giÅ¡bar	ğ’€£
U8	ğ’‡‡
m[e	ğ’ˆ¨
ÃºÅ¡	ğ’Œ€
Urta	ğ’…
si12	ğ’…Š
1051	ğ’ ğ’› ğ’Œ ğ’¹
szag5	ğ’Š·
szag4	ğ’Š®
et,	ğ’€‰
1050	ğ’ ğ’› ğ’Œ
bÃ ]n	ğ’Œ‰
á¹£Ãº	ğ’ª
1053	ğ’ ğ’› ğ’Œ ğ’ˆ
BUL+BUL,	ğ’‡§ğ’‡§
181	ğ’— ğ’¹
803	ğ’ ğ’— ğ’Œ‹ğ’Œ‹ ğ’ˆ
Å¡uku	ğ’‰»
dug5	ğ’‚…
dug4	ğ’…—
sukud	ğ’ƒ´
á¹£Ã­	ğ’£
zaraâ‚†	ğ’ğ’€¸
183	ğ’— ğ’ˆ
dug3	ğ’„­
ana2	ğ’€­
danna	ğ’†œğ’
378	ğ’š ğ’Œ‹ ğ’
379	ğ’š ğ’Œ‹ ğ’‘†
tun2	ğ’„¸
1057	ğ’ ğ’› ğ’Œ ğ’Œ
 en	ğ’‚—
373	ğ’š ğ’Œ‹ ğ’ˆ
szA3	ğ’Š®
807	ğ’ ğ’— ğ’Œ‹ğ’Œ‹ ğ’Œ
376	ğ’š ğ’Œ‹ ğ’‹
377	ğ’š ğ’Œ‹ ğ’Œ
374	ğ’š ğ’Œ‹ ğ’‰
375	ğ’š ğ’Œ‹ ğ’Š
rÃ b	ğ’ˆ—
187	ğ’— ğ’Œ
1058	ğ’ ğ’› ğ’Œ ğ’
amaÅ¡	ğ’¦
ke3	ğ’€
ke4	ğ’†¤
mabi2	ğ’€€ğ’ˆ¹ğ’²
LULIM	ğ’„
aÅ¡gab	ğ’€¿
kab2	ğ’…˜
(iku)	ğ’ƒ·
suku5	ğ’ˆ½
SUM	ğ’‹§
szaga	ğ’ˆ‚
ma me mi mu	ğ’ˆ  ğ’ˆ¨ ğ’ˆª ğ’ˆ¬
pÃ­r	ğ’‚Ÿ
kel	ğ’†¸
USAR	ğ’‡³ğ’Š¬
ru11	ğ’Œ¾
ru10	ğ’‹½
ru12	ğ’‚—
USAN	ğ’„›
ru14	ğ’Œ¸
ker	ğ’„«
pÃ­l	ğ’‰‹
á¹£u	ğ’®
aj2	ğ’‰˜
dir	ğ’‹›ğ’€€
diq	ğ’‰Œ
Å ÃRA	ğ’‡‹
dik	ğ’‰Œ
kurum7	ğ’…†ğ’‚Ÿ
dih	ğ’¾
din	ğ’·
dim	ğ’´
dil	ğ’€¸
dib	ğ’³
uÅ¡um	ğ’”
á¹£i	ğ’¢
kum2	ğ’‰ˆ
n[a?	ğ’ˆ¾
_sipa_	ğ’‰ºğ’‡»
765	ğ’ ğ’– ğ’ ğ’Š
kur12	ğ’€
di]	ğ’²
852	ğ’ ğ’˜ ğ’Œ‹ ğ’ˆ«
Ã¡b	ğ’€–
us2_	ğ’‘
851	ğ’ ğ’˜ ğ’Œ‹ ğ’¹
us2]	ğ’‘
Ã¡g	ğ’‰˜
PAN	ğ’‰¼
991	ğ’ ğ’š ğ’Œ ğ’¹
UÅ 	ğ’‘
UÅ¡	ğ’‘
husz	ğ’„­ğ’„Š
Ã¡r	ğ’Œ’
Ã¡s	ğ’€¾
á¸«ubâ‚‚	ğ’„¸
dÃ­lim	ğ’‡º
haÅ¡hur	ğ’ˆ¢
uÅ¡u3	ğ’Œ
URU	ğ’Œ·
BIR6	ğ’Š¶
di3	ğ’‹¾
PA6	ğ’‰½ğ’…–
PA5	ğ’‰½ğ’‚Š
PA3	ğ’…†ğ’Š’
di6	ğ’º
di5	ğ’Š‘
di4	ğ’Œ‰
erina8	ğ’ˆ¸ğ’€€ğ’ˆ¾
beâ‚‚	ğ’‰
Ãºz	ğ’‘
DÃŒM	ğ’ˆ•
Ãºs	ğ’‘
Ãºr	ğ’Œ«
qi2	ğ’† 
szek2	ğ’‹ 
ARAD	ğ’€´
Ãºb	ğ’‚ 
{urudu}dur10	ğ’ ğ’Š¿
siga18	ğ’†¥
46	ğ’ ğ’‹
45	ğ’ ğ’Š
44	ğ’ ğ’‰
43	ğ’ ğ’ˆ
42	ğ’ ğ’ˆ«
41	ğ’ ğ’¹
40	ğ’
994	ğ’ ğ’š ğ’Œ ğ’‰
49	ğ’ ğ’‘†
48	ğ’ ğ’
BADâ‚…	ğ’…†
kislah	ğ’† ğ’Œ“
12 1:48	ğ’Œ‹ ğ’ˆ« ğ’¹ ğ’ğ’
(lubun)	ğ’‚²
461	ğ’› ğ’ ğ’¹
_gun	ğ’„˜ğ’Œ¦
masz2	ğ’ˆ§
SA	ğ’Š“
ÃšSAN	ğ’„
iÅ¡huru5	ğ’ƒ—
t,ab3	ğ’³
[bi2	ğ’‰ˆ
gÃ©sz+u	ğ’„‘ ğ’Œ‘
Äal2	ğ’……
4	ğ’‰
ha he hi hu	ğ’„© ğ’„­ ğ’„­ ğ’„·
Kad	ğ’ƒ°
ÄœIÅ 	ğ’„‘
ilimmu4	ğ’‘ˆ
masz_	ğ’ˆ¦
Ã­min	ğ’‹°ğ’‹°ğ’‹°ğ’€¸
emmen2	ğ’…˜
SI	ğ’‹›
BURU14	ğ’‚™
delmun	ğ’‰Œğ’Œ‡
_ku3	ğ’†¬
(zi4)	ğ’€“
[sz	Å¡
pÃ©Å¡	ğ’‰¾
Å¡ir3	ğ’‚¡
_kasz	ğ’‰
SAHAR	ğ’…–
eÅ¡kiri	ğ’Œ‹ğ’‚™
lamassu	ğ’†—
(zubur)	ğ’­
lah4	ğ’»
lah5	ğ’ºğ’º
AÅ 	ğ’€¸
AÅ¡	ğ’€¸
nar	ğ’ˆœ
SÃŒLA	ğ’‹¡
TU	ğ’Œ…
ge17	ğ’ˆªğ’‰­
tam3	ğ’´
tam2	ğ’®
tÃ¬	ğ’´
 gi	ğ’„€
bÃºn	ğ’…®
gid3	ğ’Š“
gid2	ğ’
tul5	ğ’‡¯
350	ğ’™ ğ’
351	ğ’™ ğ’ ğ’¹
352	ğ’™ ğ’ ğ’ˆ«
353	ğ’™ ğ’ ğ’ˆ
354	ğ’™ ğ’ ğ’‰
355	ğ’™ ğ’ ğ’Š
356	ğ’™ ğ’ ğ’‹
357	ğ’™ ğ’ ğ’Œ
358	ğ’™ ğ’ ğ’
359	ğ’™ ğ’ ğ’‘†
bÃºr	ğ’”
Ana	ğ’¹
1800	ğ’ 
asilal4	ğ’‚¤
 ninda	ğ’ƒ»
nidaba	ğ’Šºğ’‰€
á¸ªUR;	ğ’„¯
TIBIRA	ğ’¾ğ’‰„
k[i	ğ’† 
MAÅ GI;	ğ’Œ
Sa	ğ’Š“
lagab	ğ’†¸
l[e?	ğ’‡·
 dim2	ğ’¶
á¸«ur;	ğ’„¯
babbar	ğ’Œ“
AS	ğ’Š
lagas	ğ’‰¢ğ’“ğ’†·
lagar	ğ’‡¬
_sag	ğ’Š•
(Å¡uÅ¡ur2)	ğ’€½
gi2	ğ’†¤
EÅ 21	ğ’»
EÅ 22	ğ’‡µ
963	ğ’ ğ’š ğ’ˆ
962	ğ’ ğ’š ğ’ˆ«
urâ‚ƒ?	ğ’ƒ¡
960	ğ’ ğ’š
967	ğ’ ğ’š ğ’Œ
966	ğ’ ğ’š ğ’‹
965	ğ’ ğ’š ğ’Š
964	ğ’ ğ’š ğ’‰
kukku2	ğ’ˆªğ’ˆª
969	ğ’ ğ’š ğ’‘†
968	ğ’ ğ’š ğ’
kukku5	ğ’ˆª
kinkin	ğ’„¯
TIâ‚ˆ	ğ’€‰
sumuqan	ğ’„Š
LAGAB	ğ’†¸
1020	ğ’ ğ’›
1021	ğ’ ğ’› ğ’¹
1022	ğ’ ğ’› ğ’ˆ«
1023	ğ’ ğ’› ğ’ˆ
INNIN;	ğ’ˆ¹
1025	ğ’ ğ’› ğ’Š
1026	ğ’ ğ’› ğ’‹
Arad	ğ’€´
1028	ğ’ ğ’› ğ’
1029	ğ’ ğ’› ğ’‘†
na_	ğ’ˆ¾
LAGAR	ğ’‡¬
ÄiÅ¡nimbar	ğ’Š·
_{gesz}tukul_	ğ’„‘ ğ’†ª
raÅ¡2	ğ’Œ‡
KE4	ğ’†¤
Ak	ğ’€
Al	ğ’€ 
Am	ğ’„ 
An	ğ’€­
akar	ğ’‰¬
Ab	ğ’€Š
(agarin)	ğ’€Œ
{gi}dub	ğ’„€ ğ’¾
Ã	ğ’€‰
GUR7	ğ’„¦
GUR5	ğ’€
IGI	ğ’…†
Å¡eÅ¡lam	ğ’‹‚
Isz	ğ’…–
{d}isz	ğ’€­ ğ’…–
At	ğ’€œ
<eÄ3>	ğ’‰˜
AH	ğ’„´
AK	ğ’€
AL	ğ’€ 
AM	ğ’„ 
608	ğ’ ğ’
609	ğ’ ğ’‘†
lit,	ğ’€–
607	ğ’ ğ’Œ
604	ğ’ ğ’‰
605	ğ’ ğ’Š
602	ğ’ ğ’ˆ«
603	ğ’ ğ’ˆ
600	ğ’
601	ğ’ ğ’¹
AZ	ğ’Š
 gi4	ğ’„„
qÃ©(DI)	ğ’²
kur6	ğ’‰»
AR	ğ’…ˆ
kur4	ğ’†¸
kur3	ğ’„¥
kur2	ğ’‰½
GEÅ TIN	ğ’ƒ¾
{d}Nergal	ğ’€­ ğ’ŠŠğ’€•ğ’ƒ²
itIM	ğ’ƒŸ
{d}inana	ğ’€­ ğ’ˆ¹
aya2	ğ’€€
gunni	ğ’† ğ’‰ˆ
_dumu_	ğ’Œ‰
kur_	ğ’†³
kij2	ğ’†¥
A2	ğ’€‰
ge6	ğ’ˆª
gap2	ğ’†
570	ğ’ ğ’Œ
571	ğ’ ğ’Œ ğ’¹
572	ğ’ ğ’Œ ğ’ˆ«
573	ğ’ ğ’Œ ğ’ˆ
574	ğ’ ğ’Œ ğ’‰
575	ğ’ ğ’Œ ğ’Š
szutur	ğ’ˆ¤
577	ğ’ ğ’Œ ğ’Œ
578	ğ’ ğ’Œ ğ’
579	ğ’ ğ’Œ ğ’‘†
lagaÅ¡	ğ’‰¢ğ’“ğ’†·
_gig	ğ’ˆªğ’‰­
{uru}nun{ki}	ğ’Œ· ğ’‰£ ğ’† 
szutum	ğ’„€ğ’ˆ¾ğ’€Šğ’Œ‹ğ’„
{d}sin	ğ’€­ ğ’Œ
PÃR	ğ’‚Ÿ
 saj	ğ’Š•
Å¡Ãºm	ğ’‹§
ub]	ğ’Œ’
GISKIM	ğ’…†ğ’¾
_kar_	ğ’‹¼ğ’€€
[Ã¡Å¡	ğ’€¾
e]	ğ’‚Š
dubad	ğ’† ğ’†—
e_	ğ’‚Š
567	ğ’ ğ’Œ‹ğ’Œ‹ ğ’Œ
_{gesz}ma2_	ğ’„‘ ğ’ˆ£
565	ğ’ ğ’Œ‹ğ’Œ‹ ğ’Š
564	ğ’ ğ’Œ‹ğ’Œ‹ ğ’‰
kinda2	ğ’Œµ
ea	ğ’€€
eb	ğ’…
560	ğ’ ğ’Œ‹ğ’Œ‹
el	ğ’‚–
em	ğ’…
en	ğ’‚—
lalâ‚ƒ	ğ’‹­
eh	ğ’„´
ararma	ğ’Œ“ğ’€•
ej	ğ’……
ek	ğ’……
et	ğ’€‰
ew	ğ’‰¿
ep	ğ’…
suhusz	ğ’¼
er	ğ’…•
es	ğ’„‘
[re	ğ’Š‘
tirum	ğ’ƒ²ğ’‹¼
sa10	ğ’‰š
sa11	ğ’‹œ
ex	ğ’‰¿
ez	ğ’„‘
72	ğ’• ğ’Œ‹ ğ’ˆ«
73	ğ’• ğ’Œ‹ ğ’ˆ
kÃ¨Å¡	ğ’‹™ğ’€­ğ’„²
71	ğ’• ğ’Œ‹ ğ’¹
76	ğ’• ğ’Œ‹ ğ’‹
77	ğ’• ğ’Œ‹ ğ’Œ
74	ğ’• ğ’Œ‹ ğ’‰
75	ğ’• ğ’Œ‹ ğ’Š
78	ğ’• ğ’Œ‹ ğ’
79	ğ’• ğ’Œ‹ ğ’‘†
sila3	ğ’‹¡
Iri	ğ’Œ·
_uszumgal	ğ’ƒ²ğ’”
igisztu	ğ’…†ğ’º
Å ÃšM	ğ’‹§
d[ur	ğ’„™
d+EN	ğ’€­ ğ’‚—
PUZUR4	ğ’…¤ğ’Š­
ub3	ğ’€š
ub2	ğ’‚ 
e'	ğ’€ª
ub4	ğ’‡¥
18600	ğ’§ ğ’
ezen	ğ’‚¡
ezem	ğ’‚¡
e4	ğ’€€
munussa	ğ’Š©ğ’‘ğ’²
e6	ğ’‹£
dag2	ğ’Œ“
haá¹£	ğ’‹»
dag4	ğ’†¦
e2	ğ’‚
e3	ğ’Œ“ğ’º
haá¹­	ğ’‰º
TE	ğ’‹¼
(hilibu)	ğ’‚Œ
el4	ğ’…Œ
LAGABxU	ğ’‡¥
ABUL	ğ’†ğ’ƒ²
sig3	ğ’‰º
sig4	ğ’‹
sig5	ğ’…†ğ’‚Ÿ
sig6	ğ’Š·
sig7	ğ’…Š
sig8	ğ’ƒ°ğ’‹ºğ’„‘
sig9	ğ’‹›
kÃ t	ğ’†‘
gaÅ¡	ğ’‰
Äidlam	ğ’Š©ğ’‘ğ’®
SUá¸ª;	ğ’ˆ½
SIGâ‚…	ğ’…†ğ’‚Ÿ
SIGâ‚‡	ğ’…Š
{gi}dusu	ğ’„€ ğ’…
kub	ğ’º
guhÅ¡u2	ğ’ˆğ’‹™
ÃTIMA	ğ’Œ–
{gesz}bi	ğ’„‘ ğ’‰
gesz3	ğ’‘
gesz2	ğ’•
{MUNUS}mu	ğ’Š© ğ’ˆ¬
ANSZE	ğ’€²
gesz#	ğ’„‘
de2]	ğ’Œ¤
UTUL5	ğ’Ÿ
ASILAL4	ğ’‚¤
<ma2	ğ’ˆ£
liâ‚‚	ğ’‰Œ
Sur	ğ’‹©
a'	ğ’€ª
NUM	ğ’‰
nigidaeÅ¡	ğ’‘—
NUN	ğ’‰£
liâ‚‰	ğ’‰ˆ
al2	ğ’€©
Ã 	ğ’‰¿
ak ek ik uk	ğ’€ ğ’…… ğ’…… ğ’ŠŒ
nu isz	ğ’‰¡ ğ’…–
347	ğ’™ ğ’ ğ’Œ
346	ğ’™ ğ’ ğ’‹
345	ğ’™ ğ’ ğ’Š
344	ğ’™ ğ’ ğ’‰
343	ğ’™ ğ’ ğ’ˆ
342	ğ’™ ğ’ ğ’ˆ«
_{lu2}masz	ğ’‡½ ğ’ˆ¦
340	ğ’™ ğ’
DUMU	ğ’Œ‰
349	ğ’™ ğ’ ğ’‘†
348	ğ’™ ğ’ ğ’
254	ğ’˜ ğ’Œ‹ ğ’‰
DAB	ğ’³
DAG	ğ’–
47	ğ’ ğ’Œ
s,ab	ğ’‚Ÿ
ad5	ğ’Œ‘ğ’„‰
bul	ğ’‡§
bun	ğ’‡Œ
mes,	ğ’ˆ©
buk	ğ’ˆ®
ad2	ğ’„‰
ninni7	ğ’‰»ğ’€­ğ’ˆ¹
DAR	ğ’¯
ninni5	ğ’Œƒ
t,ab	ğ’‹°
ninni2	ğ’†¸ğ’†¸
bur	ğ’“
t,al	ğ’Š‘
t,am	ğ’®
t,ah	ğ’ˆ­
luá¸«	ğ’ˆ›
eÅ¡	ğ’Œ
Å AMAN2	ğ’Œ‹ğ’ƒ¶
suh10	ğ’ˆ¹
GÃšG	ğ’ˆ–
dIsz	ğ’¹
sigâ‚â‚‡	ğ’„€
gansis	ğ’‹¯
i]m	ğ’…
t,a3	ğ’„­
GANUN	ğ’ƒ 
abgal2	ğ’‰£ğ’ˆ¨ğ’…¤
Å ÃšÅ UR	ğ’€½
Zabalam6{ki}	ğ’€Šğ’ˆ¹ ğ’† 
bu5	ğ’‡§
209	ğ’— ğ’Œ‹ğ’Œ‹ ğ’‘†
bu3	ğ’…¤
bu2	ğ’†œ
i]s	ğ’„‘
SÃ™á¸ª	ğ’„—
sun3	ğ’‹§
luá¹­	ğ’‚
_masz2	ğ’ˆ§
GASZAN	ğ’ƒ½
ENGUR	ğ’‡‰
umun2	ğ’Œ£
umun7	ğ’…“
umun6	ğ’‡Š
GADA	ğ’ƒ°
TAKâ‚„	ğ’‹º
954	ğ’ ğ’™ ğ’ ğ’‰
955	ğ’ ğ’™ ğ’ ğ’Š
952	ğ’ ğ’™ ğ’ ğ’ˆ«
953	ğ’ ğ’™ ğ’ ğ’ˆ
950	ğ’ ğ’™ ğ’
951	ğ’ ğ’™ ğ’ ğ’¹
USZ2	ğ’—
sun7	ğ’†—
958	ğ’ ğ’™ ğ’ ğ’
959	ğ’ ğ’™ ğ’ ğ’‘†
gap	ğ’ƒ®
gar	ğ’ƒ»
UR@s	ğ’Œª
1019	ğ’ ğ’š ğ’ ğ’‘†
1018	ğ’ ğ’š ğ’ ğ’
aÄa3	ğ’‚†
1015	ğ’ ğ’š ğ’ ğ’Š
1014	ğ’ ğ’š ğ’ ğ’‰
1017	ğ’ ğ’š ğ’ ğ’Œ
1016	ğ’ ğ’š ğ’ ğ’‹
1011	ğ’ ğ’š ğ’ ğ’¹
1010	ğ’ ğ’š ğ’
1013	ğ’ ğ’š ğ’ ğ’ˆ
1012	ğ’ ğ’š ğ’ ğ’ˆ«
es,	ğ’„‘
gab	ğ’ƒ®
gad	ğ’ƒ°
UDUN	ğ’Œ‹ğ’ˆ¬
ARAD2_	ğ’€µ
UDUB	ğ’‡›
gal	ğ’ƒ²
gam	ğ’ƒµ
gan	ğ’ƒ¶
uÅ¡6	ğ’‰¥
uÅ¡2	ğ’Œ€
murgu2	ğ’ˆ±
eÅ¡emen	ğ’† ğ’‚Šğ’‰ˆğ’²
(muÅ¡Å¡agana2)	ğ’‡
ga]	ğ’‚µ
(Å¡eg5)	ğ’‹
 iti	ğ’Œ—
uÅ¡!	ğ’‘
bÃ n	ğ’Œ‰
URU5;	ğ’‹½
 zib2	ğ’¨
ga2	ğ’‚·
ga3	ğ’ƒ·
ga4	ğ’ƒ»
ga5	ğ’‹¡
esz	ğ’Œ
Å¡ed3	ğ’‰«
eÅ¡kiri2	ğ’‚™
esi	ğ’†—
Ãš	ğ’Œ‘
EREÅ¡	ğ’Š©ğ’Œ†
{d}Inanna	ğ’€­ ğ’ˆ¹
ZIK;	ğ’¨
á¹£	á¹£
_dingir	ğ’€­
BIR	ğ’„µ
inanna	ğ’ˆ¹
618	ğ’ ğ’Œ‹ ğ’
615	ğ’ ğ’Œ‹ ğ’Š
kingal	ğ’ƒ²ğ’Œº
617	ğ’ ğ’Œ‹ ğ’Œ
616	ğ’ ğ’Œ‹ ğ’‹
611	ğ’ ğ’Œ‹ ğ’¹
_aga3	ğ’‚†
gar3_	ğ’ƒ¼
nimin	ğ’
(Å¡uÅ¡ur)	ğ’€¼
3 ki	ğ’ˆ ğ’† 
ban3	ğ’Œ‰
Äen]	ğ’º
{d}ir	ğ’€­ ğ’…•
{ÄeÅ¡}al	ğ’„‘ ğ’€ 
azag	ğ’†¬ğ’€­
(emeÅ¡)	ğ’Š©ğ’‡¬
<pi2>	ğ’‰
(bugin3)	ğ’‡˜
(du14)	ğ’ˆŒ
á¸«iÅ¡	ğ’Œ“
tak4	ğ’‹º
 an	ğ’€­
 al	ğ’€ 
tak2	ğ’–
 ab	ğ’€Š
 ag	ğ’€
SU?	ğ’‹¢
tur2	ğ’„™
tur3	ğ’‰£ğ’‡¬
agarin	ğ’€Œ
zibin	ğ’«
(4)	ğ’‰
tur5	ğ’Œ…
[{u2}]u2#	ğ’Œ‘ ğ’Œ‘
tur8	ğ’
szit,	ğ’‹ƒ
á¸ªUBâ‚‚	ğ’„¸
_E	ğ’‚Š
IÅ¡tar	ğ’ˆ¹
tes2	ğ’Œ¨
(gugu2)	ğ’‚­
bappir	ğ’‹‹
la le li lu	ğ’†· ğ’‡· ğ’‡· ğ’‡»
gidri	ğ’‰º
{d}nanna	ğ’€­ ğ’‹€ğ’† 
{gesz}an	ğ’„‘ ğ’€­
sagÅ¡u	ğ’Œ‹ğ’Š•
[nu]	ğ’‰¡
isz5	ğ’…—
garaÅ¡	ğ’ƒ•
GI4%GI4	ğ’„†
meze	ğ’€™
masz	ğ’ˆ¦
ZÃš	ğ’…—
á¹¢U	ğ’®
szesz	ğ’‹€
zalag2	ğ’‚Ÿ
szÃ¡h	ğ’‚„
(dan4)	ğ’ƒ‹
maâ¸£	ğ’ˆ 
ZÃ‰	ğ’¢
ZÃ	ğ’¢
ZÃŒ	ğ’¥
kalag	ğ’†—
a5	ğ’€
 a2	ğ’€‰
kalam	ğ’Œ¦
gunu3	ğ’¯
SILIM	ğ’²
szaq	ğ’Š•
szap	ğ’‰ºğ’…
GIÅ KIM	ğ’…†ğ’¾
szar	ğ’Š¬
szat	ğ’†³
szah	ğ’‹š
szak	ğ’Š•
A	ğ’€€
szam	ğ’Œ‘
szal	ğ’Š©
ar2	ğ’Œ’
szab	ğ’‰ºğ’…
szad	ğ’†³
szag	ğ’Š•
 uÄ3	ğ’Œ¦
NISAG	ğ’‰ 
Te	ğ’‹¼
mÃ¡Å¡	ğ’ˆ§
pesz10	ğ’† ğ’€€
á¸«abâ‚‚	ğ’‡¥
en7	ğ’ 
emedub	ğ’ƒ†
dar{muszen}	ğ’¯ ğ’„·
sza3	ğ’Š®
sza2	ğ’ƒ»
sza4	ğ’º
Za	ğ’
_{gesz}ig	ğ’„‘ ğ’……
12 1	ğ’Œ‹ ğ’ˆ« ğ’¹
{id2}buranun	ğ’€€ğ’‡‰ ğ’Œ“ğ’„’ğ’‰£
DAá¸ª;	ğ’ˆ­
baâ‚‡	ğ’ˆ¦
TAG4	ğ’‹º
erin2	ğ’‚Ÿ
emedu2	ğ’‚¼ğ’€€ğ’Œ…
ZU	ğ’ª
á¸«aÅ¡á¸«ur	ğ’ˆ¢
ZI	ğ’£
Ã¨nsi	ğ’‚š
giÅ¡2	ğ’•
giÅ¡3	ğ’‘
210	ğ’— ğ’Œ
974	ğ’ ğ’š ğ’Œ‹ ğ’‰
eszgiri	ğ’Œ‹ğ’‚™
976	ğ’ ğ’š ğ’Œ‹ ğ’‹
977	ğ’ ğ’š ğ’Œ‹ ğ’Œ
á¹¢Ã	ğ’£
213	ğ’— ğ’Œ ğ’ˆ
972	ğ’ ğ’š ğ’Œ‹ ğ’ˆ«
EN%EN	ğ’‚›
2(disz)	ğ’ˆ«
Å¡uÅ¡ur2	ğ’€½
#3	ğ’ˆ
_an	ğ’€­
215	ğ’— ğ’Œ ğ’Š
gara3	ğ’ƒ¼
gara2	ğ’‚¶
776	ğ’ ğ’– ğ’ ğ’‹
777	ğ’ ğ’– ğ’ ğ’Œ
774	ğ’ ğ’– ğ’ ğ’‰
775	ğ’ ğ’– ğ’ ğ’Š
772	ğ’ ğ’– ğ’ ğ’ˆ«
773	ğ’ ğ’– ğ’ ğ’ˆ
770	ğ’ ğ’– ğ’
771	ğ’ ğ’– ğ’ ğ’¹
kesz3{ki}	ğ’‹™ğ’€­ğ’„² ğ’† 
_ar	ğ’…ˆ
216	ğ’— ğ’Œ ğ’‹
Ã silal	ğ’‚¢
 ik uk	ğ’…… ğ’ŠŒ
778	ğ’ ğ’– ğ’ ğ’
779	ğ’ ğ’– ğ’ ğ’‘†
gar5	ğ’ˆ–
ganam4	ğ’‡‡
gar3	ğ’ƒ¼
dilmun{ki}	ğ’‰Œğ’Œ‡ ğ’† 
Ã€SILAL	ğ’‚¢
sa2_	ğ’²
gar8	ğ’‹
624	ğ’ ğ’Œ‹ğ’Œ‹ ğ’‰
625	ğ’ ğ’Œ‹ğ’Œ‹ ğ’Š
626	ğ’ ğ’Œ‹ğ’Œ‹ ğ’‹
627	ğ’ ğ’Œ‹ğ’Œ‹ ğ’Œ
620	ğ’ ğ’Œ‹ğ’Œ‹
621	ğ’ ğ’Œ‹ğ’Œ‹ ğ’¹
622	ğ’ ğ’Œ‹ğ’Œ‹ ğ’ˆ«
623	ğ’ ğ’Œ‹ğ’Œ‹ ğ’ˆ
628	ğ’ ğ’Œ‹ğ’Œ‹ ğ’
629	ğ’ ğ’Œ‹ğ’Œ‹ ğ’‘†
NUNa	ğ’‰£
Äir3	ğ’„Š
Äir2	ğ’„ˆ
F	ğ’Š©
uá¸«2	ğ’Œ”
gar_	ğ’ƒ»
tÃ­r	ğ’‹»
uá¸«;	ğ’„´
4(asz)	ğ’‚
(silig4)	ğ’‹µ
dalhamunâ‚…	ğ’€°
Ã©bih	ğ’‚ ğ’ˆ¤
598	ğ’ ğ’ ğ’
599	ğ’ ğ’ ğ’‘†
596	ğ’ ğ’ ğ’‹
597	ğ’ ğ’ ğ’Œ
594	ğ’ ğ’ ğ’‰
595	ğ’ ğ’ ğ’Š
592	ğ’ ğ’ ğ’ˆ«
593	ğ’ ğ’ ğ’ˆ
590	ğ’ ğ’
591	ğ’ ğ’ ğ’¹
JA2	ğ’‚·
<Å¡Ã¡	ğ’ƒ»
(sabad3)	ğ’ƒ–
24	ğ’Œ‹ğ’Œ‹ ğ’‰
kal!	ğ’†—
27	ğ’Œ‹ğ’Œ‹ ğ’Œ
edâ‚ƒ	ğ’‡¯ğ’º
Dingir	ğ’€­
kal2	ğ’ƒ²
erum4	ğ’€€ğ’‚”
Ã¹r	ğ’ƒ¡
{f}an	ğ’Š© ğ’€­
MA@g	ğ’ˆ¢
Urim5{ki}	ğ’‹€ğ’€Š ğ’† 
ÄiÅ¡kim	ğ’…†ğ’¾
muÅ¡en	ğ’„·
Ã¹z	ğ’š
{ÄeÅ¡}az	ğ’„‘ ğ’Š
ul6	ğ’Œ“
diri	ğ’‹›ğ’€€
1104	ğ’ ğ’œ ğ’Œ‹ğ’Œ‹ ğ’‰
ÄeÅ¡tugâ‚‚	ğ’„‘ğ’Œ†ğ’‰¿
Ã¹g	ğ’Œ¦
ZÃ€á¸ª	ğ’€„
dab5	ğ’†ª
1 KUG	ğ’¹ ğ’†¬
TE@g	ğ’‹½
kala	ğ’†—
ZADIM	ğ’ˆ¯
SUKKAL	ğ’ˆ›
 MU	ğ’ˆ¬
mu11	ğ’…¿
t,isz	ğ’¹
GIR9	ğ’€š
{d}Suen	ğ’€­ ğ’‚—ğ’ª
hurin	ğ’ˆ¾ğ’Š’
Geme2	ğ’Š©ğ’†³
duk2	ğ’Œ‡
Ã¹!	ğ’…‡
dir2	ğ’¯
szusz	ğ’Œ‹
bÃ d	ğ’‚¦
gig_	ğ’ˆªğ’‰­
310	ğ’™ ğ’Œ‹
uriâ‚…	ğ’‹€ğ’€Š
311	ğ’™ ğ’Œ‹ ğ’¹
Uá¸ª;	ğ’„´
pit2	ğ’1
{kuÅ¡}A2	ğ’‹¢ ğ’€‰
312	ğ’™ ğ’Œ‹ ğ’ˆ«
MÃŒN	ğ’Œ‹ğ’Œ‹
santana	ğ’ƒ²ğ’‰Œ
dilmun	ğ’‰Œğ’Œ‡
silim	ğ’²
qad2	ğ’‹—ğ’ˆ«
tumu	ğ’…
silig	ğ’‚
uÅ¡14	ğ’…¼
I3	ğ’‰Œ
{disz}szu	ğ’¹ ğ’‹—
gigi	ğ’„†
geÅ¡bu	ğ’Š’
asz@c	ğ’€¸
gugu2	ğ’‚­
eÅ¡â‚‚	ğ’‚ 
eÅ¡â‚ƒ	ğ’€Š
GIRâ‚ƒ?	ğ’„Š
si22	ğ’„€
si20	ğ’¢
Ã‰RIN	ğ’‚Ÿ
Ã‰RIM	ğ’‰ˆğ’Š’
garza	ğ’‰ºğ’€­
804	ğ’ ğ’— ğ’Œ‹ğ’Œ‹ ğ’‰
izi	ğ’‰ˆ
á¸ªÃšL	ğ’„¾
{d}nÃ¨	ğ’€­ ğ’ŠŠ
(ugra)	ğ’‡¨
tum9	ğ’…
gig4	ğ’‚†
tum4	ğ’‰
tum3	ğ’‰
tum2	ğ’º
gig2	ğ’ˆª
4271	ğ’Š¹ ğ’ ğ’• ğ’Œ‹ ğ’¹
805	ğ’ ğ’— ğ’Œ‹ğ’Œ‹ ğ’Š
U@g	ğ’´
kadra	ğ’ƒ»ğ’Š®ğ’€€
6(asz)	ğ’„
kunga	ğ’‹™ğ’€¯
ÃšS	ğ’‘
ASZ	ğ’€¸
ÃšR	ğ’Œ«
IA	ğ’…€
5 45	ğ’Š ğ’ ğ’Š
IB	ğ’…
Qar	ğ’ƒ¼
DUMGAL	ğ’‹‡
BÃ™R	ğ’Œ‹
sah4	ğ’„—
sah7	ğ’€„
sah6	ğ’„©ğ’€€
286	ğ’˜ ğ’ ğ’‹
ellat	ğ’†œğ’†³
287	ğ’˜ ğ’ ğ’Œ
,i2	ğ’Š
Å¡ih	ğ’‹š
gibil	ğ’‰‹
Å¡in	ğ’Š¿
Å¡il	ğ’‹»
Å¡im	ğ’‹†
Å¡ib	ğ’ˆ¨
(nib)	ğ’Š‹
LÃ™	ğ’ˆ–
IG	ğ’……
Å¡id	ğ’‹ƒ
sÃ­g	ğ’‹ 
GUB3	ğ’†
12105	ğ’¤ ğ’Ÿ ğ’• ğ’ ğ’Š
Å¡ir	ğ’‹“
sÃ­r	ğ’
Å¡it	ğ’‹ƒ
MÃ‰NBULUG	ğ’’
289	ğ’˜ ğ’ ğ’‘†
pusz2	ğ’‰½ğ’„¬
{d}nu	ğ’€­ ğ’‰¡
 kaskal	ğ’†œ
808	ğ’ ğ’— ğ’Œ‹ğ’Œ‹ ğ’
á¹£u2	ğ’ª
[Å¡]et	ğ’‹ƒ
nid	ğ’‘
 inim	ğ’…—
kalbu	ğ’Œ¨
{idâ‚‚}idigna	ğ’€€ğ’‡‰ ğ’„˜ğ’ƒ¼
numdum	ğ’…»
HI	ğ’„­
urâ‚‚	ğ’Œ«
emedub2	ğ’ƒ§
AS;	ğ’Š
809	ğ’ ğ’— ğ’Œ‹ğ’Œ‹ ğ’‘†
{d}inanna	ğ’€­ ğ’ˆ¹
KUSZU2	ğ’†µ
AS,	ğ’Š
qÃ©!(DI)	ğ’²
u	ğ’Œ‹
Å¡i2	ğ’‹›
Å¡i7	ğ’…Š
SIâ‚„	ğ’‹œ
43200	ğ’¬ ğ’£
KÃˆÅ 	ğ’‹™ğ’€­ğ’„²
(bara5)	ğ’‡ƒ
(emeda3)	ğ’ŒŸ
1037	ğ’ ğ’› ğ’Œ‹ ğ’Œ
1036	ğ’ ğ’› ğ’Œ‹ ğ’‹
1035	ğ’ ğ’› ğ’Œ‹ ğ’Š
1034	ğ’ ğ’› ğ’Œ‹ ğ’‰
1033	ğ’ ğ’› ğ’Œ‹ ğ’ˆ
1032	ğ’ ğ’› ğ’Œ‹ ğ’ˆ«
1031	ğ’ ğ’› ğ’Œ‹ ğ’¹
1030	ğ’ ğ’› ğ’Œ‹
abbar	ğ’†¹
1039	ğ’ ğ’› ğ’Œ‹ ğ’‘†
1038	ğ’ ğ’› ğ’Œ‹ ğ’
á¹­u2	ğ’Œ…
BAD3	ğ’‚¦
aá¹­	ğ’€œ
GAZI	ğ’“Š
qut	ğ’‹»
aá¹£	ğ’Š
qur	ğ’„¥
qup	ğ’º
(Å¡akir3)	ğ’Œ¼
qun	ğ’†²
eg	ğ’……
qul	ğ’†°
qum	ğ’„£
 iri	ğ’Œ·
sed	ğ’ˆ»
qud	ğ’‹»
a]m	ğ’„ 
a]k	ğ’€
_guru7	ğ’„¦
szuku	ğ’‰»
eÅ¡emin5	ğ’‰
eÅ¡emin4	ğ’€‘
kikkin	ğ’„¯
Å IR	ğ’‹“
zir3	ğ’ˆ²
m[at	ğ’†³
per/pir	ğ’Œ“ ğ’Œ“
garadin9	ğ’Œ
764	ğ’ ğ’– ğ’ ğ’‰
k[ar]	ğ’‹¼ğ’€€
766	ğ’ ğ’– ğ’ ğ’‹
761	ğ’ ğ’– ğ’ ğ’¹
760	ğ’ ğ’– ğ’
1(disz)	ğ’¹
762	ğ’ ğ’– ğ’ ğ’ˆ«
munuâ‚„	ğ’‰½ğ’‰½
jesz	ğ’„‘
Å IM	ğ’‹†
ellag	ğ’†¸
769	ğ’ ğ’– ğ’ ğ’‘†
768	ğ’ ğ’– ğ’ ğ’
uruâ‚…	ğ’‹½
DUNâ‚ƒ	ğ’‚…
639	ğ’ ğ’Œ ğ’‘†
aá¸«	ğ’„´
633	ğ’ ğ’Œ ğ’ˆ
826	ğ’ ğ’— ğ’ ğ’‹
RIM3	ğ’‰ˆğ’Š’
gas;	ğ’„¤
qu2	ğ’†ª
qu3	ğ’„–
635	ğ’ ğ’Œ ğ’Š
634	ğ’ ğ’Œ ğ’‰
samag2	ğ’Œ 
teg3	ğ’‹¼
UBUR	ğ’œ
{d}szim	ğ’€­ ğ’‹†
gas,	ğ’„¤
,tu	ğ’Œ…
szer3	ğ’‚¡
{anÅ¡e}kunga2	ğ’€² ğ’‹™ğ’€­
szaman2	ğ’Œ‹ğ’ƒ¶
kama	ğ’„°
megida	ğ’‹°ğ’‹¾
kÃ©Å¡	ğ’†Ÿ
usar	ğ’‡³ğ’Š¬
du	ğ’º
AMAÅ 	ğ’¦
Ã ga	ğ’‚†
kim3	ğ’
 tur	ğ’Œ‰
á¸«Ã­r	ğ’„¯
{d}masz	ğ’€­ ğ’ˆ¦
589	ğ’ ğ’ ğ’‘†
588	ğ’ ğ’ ğ’
585	ğ’ ğ’ ğ’Š
584	ğ’ ğ’ ğ’‰
587	ğ’ ğ’ ğ’Œ
Å¡iÅ¡	ğ’‹€
581	ğ’ ğ’ ğ’¹
/	ğ’‘°
583	ğ’ ğ’ ğ’ˆ
TUG2	ğ’Œ†
itima	ğ’ƒŸ
Å¡urun4	ğ’¨
tib[ira]	ğ’¾ğ’‰„
Å¡em3	ğ’€š
bÃ¡n	ğ’‘
UKKIN	ğ’Œº
kam_	ğ’„°
á¹­Ã¡r	ğ’¯
[b]ad	ğ’
(sabad2)	ğ’‚¿
54	ğ’ ğ’‰
55	ğ’ ğ’Š
56	ğ’ ğ’‹
57	ğ’ ğ’Œ
50	ğ’
51	ğ’ ğ’¹
52	ğ’ ğ’ˆ«
Å¡ik	ğ’‹
Äisz	ğ’„‘
ÄeÅ¡kim	ğ’…†ğ’¾
58	ğ’ ğ’
59	ğ’ ğ’‘†
(sabad)	ğ’ƒª
t[i	ğ’‹¾
kam3	ğ’†’
MUÅ &MUÅ ;	ğ’ˆ¶
imin	ğ’…“
risz	ğ’Š•
tÃ¹r	ğ’‰£ğ’‡¬
á¹£a á¹£e á¹£i á¹£u	ğ’ ğ’¢ ğ’¢ ğ’®
2 18	ğ’ˆ« ğ’Œ‹ ğ’
ISZTAR	ğ’ˆ¹
ud2	ğ’€¾
ud5	ğ’š
ud6	ğ’Œ‹ğ’‚µ
baá¸«arâ‚‚	ğ’ƒ
_iri	ğ’Œ·
ugu2	ğ’€€ğ’…—
ugu3	ğ’€€ğ’Š•
banÅ¡ur	ğ’
GAG_	ğ’†•
ugu4	ğ’†ª
k[a]	ğ’…—
geme2	ğ’Š©ğ’†³
geme3	ğ’€µ
SUR10	ğ’ˆ£ğ’…Š
asil	ğ’‚°
ALIM	ğ’„‹
ablal	ğ’†¼
murub4	ğ’‰ 
[t]e	ğ’‹¼
kingusila	ğ’‘œ
[t]a	ğ’‹«
[t]i	ğ’‹¾
GIR5	ğ’½
esir5	ğ’„†
Å Ãš	ğ’‹™
gub	ğ’º
IZI	ğ’‰ˆ
esir2	ğ’‡’
GUâ‚„	ğ’„
(eru3)	ğ’ŠŸ
GUâ‚‚	ğ’„˜
{d}er3	ğ’€­ ğ’€´
lim3	ğ’‡´
DE3	ğ’‰ˆ
D	ğ’€­
[Å¡]Ã¡	ğ’ƒ»
reme2	ğ’€–
(ki)	ğ’† 
se2	ğ’£
ARAD2	ğ’€µ
[{u2}]u2#?	ğ’Œ‘ ğ’Œ‘
1096	ğ’ ğ’œ ğ’Œ‹ ğ’‹
ANU	ğ’€­
 tul2	ğ’‡¥
BÃšR	ğ’”
ugun	ğ’Œ‹ğ’¯
Å¡ip	ğ’ˆ¨
PÃˆÅ 	ğ’ˆ 
iÅ¡tar	ğ’ˆ¹
re7#	ğ’»
1093	ğ’ ğ’œ ğ’Œ‹ ğ’ˆ
0161	ğ’– ğ’ ğ’¹
1092	ğ’ ğ’œ ğ’Œ‹ ğ’ˆ«
ugu_	ğ’Œ‹ğ’…—
918	ğ’ ğ’™ ğ’Œ‹ ğ’
919	ğ’ ğ’™ ğ’Œ‹ ğ’‘†
simug	ğ’Œ£
912	ğ’ ğ’™ ğ’Œ‹ ğ’ˆ«
913	ğ’ ğ’™ ğ’Œ‹ ğ’ˆ
910	ğ’ ğ’™ ğ’Œ‹
911	ğ’ ğ’™ ğ’Œ‹ ğ’¹
916	ğ’ ğ’™ ğ’Œ‹ ğ’‹
917	ğ’ ğ’™ ğ’Œ‹ ğ’Œ
914	ğ’ ğ’™ ğ’Œ‹ ğ’‰
915	ğ’ ğ’™ ğ’Œ‹ ğ’Š
kas2	ğ’‰
kas3	ğ’„¤
mussa/nij2	ğ’Š©ğ’‘ğ’² ğ’ƒ»
muszen	ğ’„·
{d}id2	ğ’€­ ğ’€€ğ’‡‰
888	ğ’ ğ’˜ ğ’ ğ’
889	ğ’ ğ’˜ ğ’ ğ’‘†
[e2]	ğ’‚
586	ğ’ ğ’ ğ’‹
sa9	ğ’ˆ¦
sa4	ğ’„·ğ’ˆ¿
sa5	ğ’‹›ğ’€€
882	ğ’ ğ’˜ ğ’ ğ’ˆ«
883	ğ’ ğ’˜ ğ’ ğ’ˆ
884	ğ’ ğ’˜ ğ’ ğ’‰
885	ğ’ ğ’˜ ğ’ ğ’Š
886	ğ’ ğ’˜ ğ’ ğ’‹
sa3	ğ’
algameÅ¡	ğ’Œ“ğ’Š©ğ’„¸
LUGUD2	ğ’†¸
miÅ¡2	ğ’ˆ¨ğ’Œ
bÃ¡bbar	ğ’Œ“ğ’Œ“
miÅ¡3	ğ’„‘
SUG	ğ’†¹
t,ar3	ğ’°
lisz	ğ’‡º
kÃ á¹£	ğ’„¤
tim2	ğ’Œˆ
gÃ­dim	ğ’ˆ¦ğ’Œ‹
sukal	ğ’ˆ›
sal	ğ’Š©
sam	ğ’Œ‘
san	ğ’Š•
_garza	ğ’‰ºğ’€­
sah	ğ’†¤
saj	ğ’Š•
sak	ğ’Š•
dim11	ğ’ˆ—ğ’„°
sag	ğ’Š•
ÄuruÅ¡	ğ’„¨
sab	ğ’‰ºğ’…
[Å¡]i	ğ’…†
743	ğ’ ğ’– ğ’Œ‹ğ’Œ‹ ğ’ˆ
742	ğ’ ğ’– ğ’Œ‹ğ’Œ‹ ğ’ˆ«
{gesz}sag	ğ’„‘ ğ’Š•
740	ğ’ ğ’– ğ’Œ‹ğ’Œ‹
747	ğ’ ğ’– ğ’Œ‹ğ’Œ‹ ğ’Œ
746	ğ’ ğ’– ğ’Œ‹ğ’Œ‹ ğ’‹
745	ğ’ ğ’– ğ’Œ‹ğ’Œ‹ ğ’Š
uá¹£	ğ’Š»
sat	ğ’†³
uá¹­	ğ’Œ“
749	ğ’ ğ’– ğ’Œ‹ğ’Œ‹ ğ’‘†
748	ğ’ ğ’– ğ’Œ‹ğ’Œ‹ ğ’
sap	ğ’‰ºğ’…
sar	ğ’Š¬
[un	ğ’Œ¦
ERIN2	ğ’‚Ÿ
BUL	ğ’‡§
{jiÅ¡}Å¡u	ğ’„‘ ğ’‹—
nanna	ğ’‹€ğ’† 
651	ğ’ ğ’ ğ’¹
sa]	ğ’Š“
taÅ¡	ğ’Œ¨
652	ğ’ ğ’ ğ’ˆ«
655	ğ’ ğ’ ğ’Š
<MAN	ğ’Œ‹ğ’Œ‹
657	ğ’ ğ’ ğ’Œ
BUR	ğ’“
{d}gilgameÅ¡2	ğ’€­ ğ’„‘ğ’‰‹ğ’‚µğ’ˆ¨ğ’Œ‹ğ’Œ‹ğ’Œ‹
658	ğ’ ğ’ ğ’
iÅ¡kur	ğ’…
illat	ğ’†œğ’†³
jedru/jidru	ğ’‰º ğ’‰º
itim	ğ’ƒŸ
Å Ã™DU	ğ’†ƒ
illar	ğ’Š’
gala5	ğ’‡
gala4	ğ’†½
guggim	ğ’ˆ®
itid	ğ’Œ—
gagirsu	ğ’ƒ
erin4	ğ’ƒ«
hir2	ğ’„¯
alad2	ğ’†—
kan4	ğ’†
kan3	ğ’Š
kan2	ğ’ƒ·
[enim	ğ’…—
lirum	ğ’‹—ğ’†—
MES:KEÅ â‚‚	ğ’ˆ© ğ’†Ÿ
uszur3	ğ’‡³ğ’†¸
7 1	ğ’Œ ğ’¹
DÃšB	ğ’‚€
ug2	ğ’ŠŠ
ug3	ğ’Œ¦
ug4	ğ’Œ“
ug5	ğ’‚¦
ug6	ğ’…†ğ’‚
pa pe ip up	ğ’‰º ğ’‰¿ ğ’… ğ’Œ’
DÃšR	ğ’‚‰
gib	ğ’„ƒ
dusu2	ğ’€²ğ’…†ğ’‚ 
Å¡ÃºÅ¡ur	ğ’€½
nisaba	ğ’Šºğ’‰€
sum2	ğ’®
sum3	ğ’‹¢
[gilgameÅ¡2]	ğ’„‘ğ’‰‹ğ’‚µğ’ˆ¨ğ’Œ‹ğ’Œ‹ğ’Œ‹
sum6	ğ’‹³
sum4	ğ’…¾
NIMIN	ğ’
galam	ğ’ƒ´
GIR3	ğ’„Š
iti6	ğ’Œ“ğ’€­ğ’‹€ğ’† 
uga	ğ’Œ‘ğ’‰€ğ’‚µ
Å¡arÃ¡	ğ’‡‹
gub!	ğ’º
gU2	ğ’„˜
(udub)	ğ’‡›
ugu	ğ’Œ‹ğ’…—
GAl2	ğ’……
arali	ğ’‚ğ’†³ğ’
394	ğ’š ğ’Œ ğ’‰
395	ğ’š ğ’Œ ğ’Š
396	ğ’š ğ’Œ ğ’‹
397	ğ’š ğ’Œ ğ’Œ
390	ğ’š ğ’Œ
391	ğ’š ğ’Œ ğ’¹
392	ğ’š ğ’Œ ğ’ˆ«
393	ğ’š ğ’Œ ğ’ˆ
LISZ	ğ’‡º
12038	ğ’¤ ğ’Ÿ ğ’Œ ğ’
399	ğ’š ğ’Œ ğ’‘†
i5	ğ’…—
e[n	ğ’‚—
 dili	ğ’€¸
gakkul	ğ’Œ‹ğ’µ
MÃ™	ğ’…¡
ta3	ğ’‹³
ta2	ğ’•
ÄeÅ¡nu	ğ’‰¢ğ’„‘
Å¡um3	ğ’ˆ¬
ta6	ğ’‹º
ta5	ğ’Œ“
ta4	ğ’®
lÃ­l	ğ’†¤
ta?	ğ’‹«
GIÅ IMMAR;	ğ’Š·
saÄ	ğ’Š•
kÃ¬d	ğ’€
lÃ­p	ğ’†—
Å¡eÅ¡4	ğ’‚
eÅ¡2	ğ’‚ 
{munus}ki	ğ’Š© ğ’† 
Å¡eÅ¡2	ğ’‹
eÅ¡3	ğ’€Š
NIGIDAMIN	ğ’‘–
Ã‰	ğ’‚
Aá¸«	ğ’„´
agrun	ğ’‚ğ’‰£
_4_	ğ’‰
ta]	ğ’‹«
zulumhi	ğ’‹ ğ’‹¤
nusku	ğ’‰ºğ’Œ†
sam2	ğ’‰š
DÃŒLIB	ğ’Š 
tas	ğ’Œ¨
tar	ğ’‹»
taq	ğ’‹³
tap	ğ’‹°
tat	ğ’‹º
(sidug)	ğ’‡‚
gara2!	ğ’‚¶
[men	ğ’ƒ
aÅ¡nan2	ğ’Šº
 hul	ğ’…†ğ’Œ¨
tab	ğ’‹°
 sug6	ğ’‹¢
tag	ğ’‹³
puzur5	ğ’…¤
IÅ Å EBU	ğ’¹ğ’¹ğ’¹ğ’Œ‹ğ’Œ‹
SZUB	ğ’Š’
tak	ğ’‹³
422	ğ’› ğ’ˆ«
SA10	ğ’‰š
puzur4	ğ’…¤ğ’Š­
tan	ğ’†—
tam	ğ’Œ“
tal	ğ’Š‘
[bÃ©]	ğ’‰
aga	ğ’‚‡
AMA	ğ’‚¼
ÃŒLIMMU	ğ’‘‡
 kan4	ğ’†
a[m	ğ’„ 
gurun	ğ’„§
gurum	ğ’ƒµ
[m	ğ’¹
709	ğ’ ğ’• ğ’ ğ’‘†
Å¡un;	ğ’Š¿
[i	ğ’„¿
[d	ğ’€­
[e	ğ’‚Š
saj5	ğ’‰ 
saj4	ğ’ˆ—
PÃ‰Å 	ğ’‰¾
{d}Dumu	ğ’€­ ğ’Œ‰
[á¹£e	ğ’¢
(garaÅ¡)	ğ’ƒ•
l[u	ğ’‡»
[ÄeÅ¡	ğ’„‘
zizna	ğ’ŒŠ
gara10	ğ’‚µğ’‰Œ
KURUM7	ğ’…†ğ’‚Ÿ
Å¡arâ‚‚	ğ’Š¹
h]ar	ğ’„¯
uzug	ğ’ ğ’€­
dumu#	ğ’Œ‰
zukum	ğ’¤ğ’†¸
galâ‚‚	ğ’……
guru3	ğ’…
[3	ğ’ˆ
Å¡embulug	ğ’’
gu[b]	ğ’º
sugal7	ğ’ˆ›
ag2	ğ’‰˜
(gug5)	ğ’ˆ™
320	ğ’™ ğ’Œ‹ğ’Œ‹
Eâ‚‚	ğ’‚
Eâ‚ƒ	ğ’Œ“ğ’º
muzug2	ğ’Œ‘ğ’…—
AM3	ğ’€€ğ’€­
SUR9	ğ’‹ª
4(diÅ¡)	ğ’‰
_uzu	ğ’œ
Å¡ita2	ğ’‚·ğ’„‘
Å¡aá¹­	ğ’†³
(am4)	ğ’ƒ˜
muÅ¡tug	ğ’‰¿
{gisz}kesz2	ğ’„‘ ğ’†Ÿ
_munus	ğ’Š©
erÃ­n	ğ’‚Ÿ
lÃ á¸«	ğ’ˆ›
pÃ¨Å¡	ğ’ˆ 
muÅ¡â‚ƒ:ME	ğ’ˆ¹ ğ’ˆ¨
t,u2	ğ’Œ…
lÃ­b	ğ’†—
6(gesz2)	ğ’š
Å¡uâ‚‚	ğ’‹™
{disz}ur	ğ’¹ ğ’Œ¨
909	ğ’ ğ’™ ğ’‘†
908	ğ’ ğ’™ ğ’
kÃ­n!	ğ’„¯
MeÅ¡	ğ’ˆ¨ğ’Œ
GI4&GI4	ğ’„…
7 i	ğ’Œ ğ’„¿
901	ğ’ ğ’™ ğ’¹
11 1	ğ’Œ‹ ğ’¹ ğ’¹
SUKUD	ğ’ƒ´
902	ğ’ ğ’™ ğ’ˆ«
905	ğ’ ğ’™ ğ’Š
904	ğ’ ğ’™ ğ’‰
907	ğ’ ğ’™ ğ’Œ
906	ğ’ ğ’™ ğ’‹
sza3_	ğ’Š®
SZESZ	ğ’‹€
Å¡aá¸«	ğ’‹š
[l]u	ğ’‡»
maâ‚‚	ğ’ˆ£
[nam	ğ’‰†
silig5	ğ’
rig	ğ’‹†
silig3	ğ’‹¸
silig2	ğ’‹¹
899	ğ’ ğ’˜ ğ’ ğ’‘†
898	ğ’ ğ’˜ ğ’ ğ’
897	ğ’ ğ’˜ ğ’ ğ’Œ
896	ğ’ ğ’˜ ğ’ ğ’‹
895	ğ’ ğ’˜ ğ’ ğ’Š
894	ğ’ ğ’˜ ğ’ ğ’‰
893	ğ’ ğ’˜ ğ’ ğ’ˆ
892	ğ’ ğ’˜ ğ’ ğ’ˆ«
891	ğ’ ğ’˜ ğ’ ğ’¹
ge#	ğ’„€
habrud2	ğ’†¡
_uri{ki}_	ğ’Œµ ğ’† 
lak?]	ğ’‹ƒ
_gir2	ğ’„ˆ
dÃ¹	ğ’†•
til3	ğ’‹¾
Å ITIM	ğ’¶
gasz	ğ’‰
1113	ğ’ ğ’œ ğ’Œ ğ’ˆ
Gala	ğ’‘ğ’†ª
IÅ TAR	ğ’ˆ¹
ginâ‚‚	ğ’‚†
{lu2}azlag4	ğ’‡½ ğ’„‘ğ’Œ†ğ’‹¼ğ’€€ğ’º
{lu2}azlag5	ğ’‡½ ğ’„‘ğ’Œ†ğ’‰¿ğ’‹¼ğ’€€
{lu2}azlag7	ğ’‡½ ğ’ˆ
{lu2}azlag2	ğ’‡½ ğ’Œ†
{lu2}azlag3	ğ’‡½ ğ’„‘ğ’Œ†ğ’‰¿ğ’‹¼ğ’€€ğ’º
tukumbi	ğ’‹—ğ’ƒ»ğ’Œ‰ğ’‡²ğ’‰
guruÅ¡	ğ’„¨
SZESZ2	ğ’‹
2	ğ’ˆ«
1114	ğ’ ğ’œ ğ’Œ ğ’‰
na[p	ğ’€®
NITAH	ğ’‘
Å Aá¸ª	ğ’‹š
_2(disz)	ğ’ˆ«
wa	ğ’‰¿
su{ki}	ğ’‹¢ ğ’† 
giÅ¡immar	ğ’Š·
TUKUL	ğ’†ª
64	ğ’• ğ’‰
ye	ğ’‰¿
367	ğ’š ğ’Œ
zag	ğ’ 
61	ğ’• ğ’¹
tidnum	ğ’Š
60	ğ’•
TUGUL	ğ’‰„ğ’
samag	ğ’Œ
ubur	ğ’œ
q[Ã©	ğ’† 
á¹­a á¹­e á¹­i á¹­u	ğ’• ğ’² ğ’² ğ’‚…
_sza3_	ğ’Š®
buru15	ğ’‰¢ğ’…•
NITA2	ğ’€´
sa se si su	ğ’Š“ ğ’‹› ğ’‹› ğ’‹¢
Bit	ğ’‚
GEMÃ‰	ğ’Š©ğ’†³
j	Å‹
DU10	ğ’„­
(giÅ¡bar)	ğ’€£
sibir	ğ’Œ‹ğ’‚™
gÃºb	ğ’‡·
usan	ğ’„›
gÃºg	ğ’ˆ–
iÅ¡Å¡ebu	ğ’¹ğ’¹ğ’¹ğ’Œ‹ğ’Œ‹
szur5	ğ’‡²ğ’†¸
t,am2	ğ’Œ“
 gana2	ğ’ƒ·
saga_	ğ’Š•
szur3	ğ’‹“
jesz2	ğ’•
jesz3	ğ’‘
sibir2	ğ’‚™
namâ‚‚	ğ’‰‡
gub_	ğ’º
garasz3	ğ’‚µğ’†œ
sik2	ğ’‹ 
id5	ğ’€€
id4	ğ’Œ“ğ’€­ğ’‹€ğ’† 
id7	ğ’€€ğ’‡‰ğ’²
HÃD	ğ’Œ“
sakar	ğ’Š¬
id3	ğ’‡‰
en6	ğ’…”
ge23	ğ’€¹
 e	ğ’‚Š
we	ğ’‰¿
ge26	ğ’‚·
ÄeÅ¡tu2	ğ’„‘ğ’Œ†ğ’‰¿
556	ğ’ ğ’Œ‹ ğ’‹
qab3	ğ’•
qab2	ğ’†
[te]	ğ’‹¼
gibil4	ğ’‰ˆ
gibil6	ğ’‰ˆğ’„€
1119	ğ’ ğ’œ ğ’Œ ğ’‘†
unu6	ğ’‹¼ğ’€Š
zir2	ğ’‚ ğ’…—
gibil;	ğ’‰‹
Ê¾	ğ’€ª
unu2	ğ’‹¼ğ’€•
JISZ	ğ’„‘
babbar2	ğ’Œ“ğ’Œ“
(agarin2)	ğ’€
eszgal	ğ’€
(muh2)	ğ’Šš
anzud{muÅ¡en}	ğ’€­ğ’…ğ’‚‚ ğ’„·
siki	ğ’‹ 
adkin	ğ’‹ ğ’‡´
gud10	ğ’†
{d}nin	ğ’€­ ğ’Š©ğ’Œ†
unug	ğ’€•
lubun	ğ’‚²
unud	ğ’€–ğ’†ª
767	ğ’ ğ’– ğ’ ğ’Œ
GIâ‚‡	ğ’‚ 
Å¡Ã 	ğ’Š®
_geme2	ğ’Š©ğ’†³
Å ID	ğ’‹ƒ
dinig2	ğ’ˆ‹
383	ğ’š ğ’Œ‹ğ’Œ‹ ğ’ˆ
382	ğ’š ğ’Œ‹ğ’Œ‹ ğ’ˆ«
381	ğ’š ğ’Œ‹ğ’Œ‹ ğ’¹
380	ğ’š ğ’Œ‹ğ’Œ‹
387	ğ’š ğ’Œ‹ğ’Œ‹ ğ’Œ
386	ğ’š ğ’Œ‹ğ’Œ‹ ğ’‹
385	ğ’š ğ’Œ‹ğ’Œ‹ ğ’Š
disz	ğ’¹
ka ke ki ku	ğ’…— ğ’†  ğ’†  ğ’†ª
763	ğ’ ğ’– ğ’ ğ’ˆ
lugal	ğ’ˆ—
ÄÃ©Å¡tug	ğ’„‘ğ’Œ†ğ’‰¿
672	ğ’ ğ’• ğ’Œ‹ ğ’ˆ«
unu	ğ’€•
gan2	ğ’ƒ·
ÃšÅ 	ğ’—
Uri5	ğ’‹€ğ’€Š
abba2	ğ’€‹
dalla;	ğ’ˆ¦ğ’„˜ğ’ƒ¼
gurun7	ğ’‚
kunga2	ğ’‹™ğ’€­
671	ğ’ ğ’• ğ’Œ‹ ğ’¹
á¹£ar	ğ’‡¡
á¹£al	ğ’‰Œ
Å¡]a	ğ’Š­
'	ğ’€ª
 galam	ğ’ƒ´
á¹£ab	ğ’‚Ÿ
Å¡]i	ğ’…†
gi6	ğ’ˆª
giÄ4	ğ’‚†
Å UDUN	ğ’‹™
1(bur3)	ğ’Œ‹
Å UDUL	ğ’‹™
gÃ­bil	ğ’‹™ğ’€¾
giri17	ğ’…—
giri16	ğ’„Œ
abul	ğ’†ğ’ƒ²
Å EN	ğ’Š¿
saá¸«2	ğ’‹š
USSU	ğ’‘„
721	ğ’ ğ’– ğ’¹
720	ğ’ ğ’–
723	ğ’ ğ’– ğ’ˆ
722	ğ’ ğ’– ğ’ˆ«
725	ğ’ ğ’– ğ’Š
724	ğ’ ğ’– ğ’‰
727	ğ’ ğ’– ğ’Œ
726	ğ’ ğ’– ğ’‹
dur2	ğ’‚‰
dur3	ğ’€²ğ’€´
dim9	ğ’ˆ—ğ’ƒ¶
dim8	ğ’Šğ’ƒ¶
dur4	ğ’„’
dur5	ğ’€€
dim3	ğ’ˆš
dim2	ğ’¶
dur9	ğ’‚„
dim7	ğ’
738	ğ’ ğ’– ğ’Œ‹ ğ’
MÃÅ 	ğ’ˆ§
dim4	ğ’‰½ğ’‰½
BARA2	ğ’ˆ
[ha	ğ’„©
679	ğ’ ğ’• ğ’Œ‹ ğ’‘†
678	ğ’ ğ’• ğ’Œ‹ ğ’
677	ğ’ ğ’• ğ’Œ‹ ğ’Œ
676	ğ’ ğ’• ğ’Œ‹ ğ’‹
675	ğ’ ğ’• ğ’Œ‹ ğ’Š
674	ğ’ ğ’• ğ’Œ‹ ğ’‰
673	ğ’ ğ’• ğ’Œ‹ ğ’ˆ
631	ğ’ ğ’Œ ğ’¹
dÃ r	ğ’°
670	ğ’ ğ’• ğ’Œ‹
RIM2	ğ’€–
aÅ¡dar;	ğ’Œ‹ğ’¯
637	ğ’ ğ’Œ ğ’Œ
niq2	ğ’ƒ»
gurusz3	ğ’€
RIM4	ğ’½
re7	ğ’»
hisz	ğ’Œ“
rit	ğ’ˆ©
re2	ğ’Œ·
girid2	ğ’„Œ
bÃ­l	ğ’‰‹
qa qe qi qu	ğ’‹¡ ğ’†¥ ğ’†¥ ğ’„£
[ti	ğ’‹¾
Ãºmbisag	ğ’‹„
[te	ğ’‹¼
MÃšRU	ğ’‰ 
dili2	ğ’‡º
[ta	ğ’‹«
(gazag)	ğ’ƒœ
[tu	ğ’Œ…
ad ed id ud	ğ’€œ ğ’€‰ ğ’€‰ ğ’Œ“
2 eÅ¡	ğ’ˆ« ğ’Œ
red	ğ’ˆ©
ku(4)	ğ’‰ ğ’‰
Ã€Å 	ğ’‹
_nig2	ğ’ƒ»
reb	ğ’†—
rem	ğ’†¸
ret	ğ’ˆ©
keÅ¡e2	ğ’†Ÿ
taka4	ğ’‹º
sizkur2	ğ’€¬ğ’€¬
TUKU	ğ’Œ‡
 kir11	ğ’Š©ğ’ƒ¢
ensi	ğ’‚—ğ’ˆ¨ğ’‡·
edin	ğ’‚”
sabad	ğ’ƒª
niÅ¡	ğ’Œ‹ğ’Œ‹
ÃšTU	ğ’Œ‹ğ’‚µ
bisz	ğ’„«
SIG17	ğ’„€
GaÅ¡	ğ’‰
kuru13	ğ’„¦
á¹£e	ğ’¢
{d}alad	ğ’€­ ğ’†˜
dilib	ğ’‹ƒ
uh3	ğ’†µ
uh2	ğ’Œ”
suâ‚ƒ	ğ’‹¤
suâ‚„	ğ’‹œ
_gu4_	ğ’„
Å UP2	ğ’€¸
 mu	ğ’ˆ¬
iá¹­	ğ’€‰
du7	ğ’ŒŒ
du6	ğ’‡¯
du5	ğ’‚…
du4	ğ’Œˆ
du3	ğ’†•
du2	ğ’Œ…
asal2	ğ’€€ğ’Œ…ğ’ƒ®ğ’‡º
ZUR	ğ’€«
qisz	ğ’†§
du9	ğ’”
du8	ğ’ƒ®
KIÅ I4	ğ’Š”
985	ğ’ ğ’š ğ’Œ‹ğ’Œ‹ ğ’Š
e11]	ğ’‡¯ğ’º
{geÅ¡}A	ğ’„‘ ğ’€€
GEÅ 	ğ’„‘
KIÅ I8	ğ’
ibila	ğ’Œ‰ğ’‘
meÅ¡2	ğ’ˆ¨
meÅ¡3	ğ’ˆ©
kÃºnga	ğ’‹™ğ’€­
dug	ğ’‚
hÃ¡	ğ’„­ğ’€€
DINGIR	ğ’€­
[gub	ğ’º
m[eÅ¡	ğ’ˆ¨ğ’Œ
dun	ğ’‚„
hÃ©	ğ’ƒ¶
iá¸«	ğ’„´
duk	ğ’‚
(akar)	ğ’‰¬
{gesz}ma	ğ’„‘ ğ’ˆ 
Ã¬min	ğ’‘
NÃTA	ğ’€´
IBILA	ğ’Œ‰ğ’‘
duq	ğ’‚
KIÅ IB	ğ’ˆ©
KAD5	ğ’†“
KAD4	ğ’†’
wi	ğ’‰¿
662	ğ’ ğ’• ğ’ˆ«
bulug2	ğ’”
taÅ¡karin	ğ’Œ†
240	ğ’˜
gÃ¹d	ğ’Œ‘ğ’† ğ’‹§ğ’‚µ
(sur9)	ğ’‹ª
le10	ğ’•
re]b	ğ’†—
du_	ğ’º
Å EÅ 	ğ’‹€
(agargara)	ğ’‰©
jesztin	ğ’ƒ¾
KADRA	ğ’ƒ»ğ’Š®ğ’€€
RÃ	ğ’º
kÃ¬ri	ğ’…—
szem	ğ’‹†
szen	ğ’Š¿
ul{ki}	ğ’ŒŒ ğ’† 
dida	ğ’‰ğ’Œ‘ğ’Š“
szet	ğ’‹ƒ
198	ğ’— ğ’Œ‹ ğ’
199	ğ’— ğ’Œ‹ ğ’‘†
gÃ¡raÅ¡	ğ’† ğ’†˜
IM%IM	ğ’…
192	ğ’— ğ’Œ‹ ğ’ˆ«
193	ğ’— ğ’Œ‹ ğ’ˆ
{d}IM	ğ’€­ ğ’…
191	ğ’— ğ’Œ‹ ğ’¹
GAB;	ğ’ƒ®
ab2	ğ’€–
194	ğ’— ğ’Œ‹ ğ’‰
195	ğ’— ğ’Œ‹ ğ’Š
Ga2	ğ’‚·
nu	ğ’‰¡
á¸«Ã¡Å¡	ğ’¨
653	ğ’ ğ’ ğ’ˆ
suá¸«â‚…	ğ’†ª
[iá¹­	ğ’€‰
a5]	ğ’€
maszkim	ğ’‰ºğ’½
{d#}isz#	ğ’€­ ğ’…–
Ã©meÅ¡	ğ’‰Š
sze_	ğ’Šº
ukurâ‚‚	ğ’ƒ²ğ’‹š
3(gesz'u)	ğ’ 
930	ğ’ ğ’™ ğ’Œ
k]Ã¡	ğ’†
932	ğ’ ğ’™ ğ’Œ ğ’ˆ«
933	ğ’ ğ’™ ğ’Œ ğ’ˆ
reÅ¡	ğ’Š•
935	ğ’ ğ’™ ğ’Œ ğ’Š
he	ğ’„­
jesztug2	ğ’„‘ğ’Œ†ğ’‰¿
938	ğ’ ğ’™ ğ’Œ ğ’
939	ğ’ ğ’™ ğ’Œ ğ’‘†
hi	ğ’„­
aba	ğ’€Š
(muÅ¡Å¡agana)	ğ’‡š
Tilmun	ğ’‰Œğ’Œ‡
717	ğ’ ğ’• ğ’ ğ’Œ
huÄ	ğ’‚ 
sze3	ğ’‚ 
sze2	ğ’‹›
GaL	ğ’ƒ²
sze8	ğ’‹
wÃ­	ğ’Š…
GABA	ğ’ƒ®
(kid7)	ğ’…
á¹­eâ‚„	ğ’‹¼
TAá¸ª	ğ’ˆ­
gir15	ğ’‚ 
Gal	ğ’ƒ²
927	ğ’ ğ’™ ğ’Œ‹ğ’Œ‹ ğ’Œ
zi8	ğ’†—
925	ğ’ ğ’™ ğ’Œ‹ğ’Œ‹ ğ’Š
924	ğ’ ğ’™ ğ’Œ‹ğ’Œ‹ ğ’‰
923	ğ’ ğ’™ ğ’Œ‹ğ’Œ‹ ğ’ˆ
922	ğ’ ğ’™ ğ’Œ‹ğ’Œ‹ ğ’ˆ«
addir	ğ’€€ğ’‰ºğ’„ğ’‰»ğ’‹›ğ’€€
920	ğ’ ğ’™ ğ’Œ‹ğ’Œ‹
bilâ‚‚	ğ’‰‹
udu	ğ’‡»
zi3	ğ’¥
EL	ğ’‚–
zi4	ğ’€“
929	ğ’ ğ’™ ğ’Œ‹ğ’Œ‹ ğ’‘†
928	ğ’ ğ’™ ğ’Œ‹ğ’Œ‹ ğ’
Qa2	ğ’‚µ
zi*	ğ’£
iá¹£	ğ’„‘
munsub;	ğ’ˆ°
582	ğ’ ğ’ ğ’ˆ«
immal2	ğ’‰¦
am em mi um	ğ’„  ğ’… ğ’ˆª ğ’Œ
 ÄuruÅ¡	ğ’„¨
NÃŒGIN	ğ’Œ‹ğ’Œ“ğ’†¤
niÄ2	ğ’ƒ»
[ki	ğ’† 
ziz	ğ’
UGULA	ğ’‰º
SÃN	ğ’‰†
Kim	ğ’¶
ziq	ğ’¨
desz/tesz	ğ’¹ ğ’€¸
zir	ğ’†°
NÃGIN	ğ’†¸
SÃG	ğ’‹ 
1(u)	ğ’Œ‹
zik	ğ’¨
zil	ğ’‰£
{d}zar	ğ’€­ ğ’‡¡
it,	ğ’€‰
dusu	ğ’…
zib	ğ’¦
zid	ğ’£
zig	ğ’¨
munzer	ğ’† ğ’€­ğ’‹€ğ’† 
gurum2	ğ’…†ğ’‚Ÿ
dabin	ğ’‚ ğ’Šº
INANA	ğ’ˆ¹
aka	ğ’€
lahar	ğ’‡‡
553	ğ’ ğ’Œ‹ ğ’ˆ
_{lu2}ensi_	ğ’‡½ ğ’‚—ğ’ˆ¨ğ’‡·
_musz_	ğ’ˆ²
inda3	ğ’ƒ»
 Å¡ag4	ğ’Š®
_sila_	ğ’‹»
tij4	ğ’‹¾
780	ğ’ ğ’—
GuruÅ¡	ğ’„¨
az ez iz uz	ğ’Š ğ’„‘ ğ’„‘ ğ’Š»
lip2	ğ’†—
3(u)	ğ’Œ
jeszbun	ğ’† ğ’‰ğ’ƒ»
kÃ­Ä	ğ’†¥
758	ğ’ ğ’– ğ’Œ ğ’
759	ğ’ ğ’– ğ’Œ ğ’‘†
754	ğ’ ğ’– ğ’Œ ğ’‰
755	ğ’ ğ’– ğ’Œ ğ’Š
756	ğ’ ğ’– ğ’Œ ğ’‹
757	ğ’ ğ’– ğ’Œ ğ’Œ
750	ğ’ ğ’– ğ’Œ
751	ğ’ ğ’– ğ’Œ ğ’¹
752	ğ’ ğ’– ğ’Œ ğ’ˆ«
753	ğ’ ğ’– ğ’Œ ğ’ˆ
kin7	ğ’º
kin3	ğ’†³
kaÅ¡2	ğ’†œ
arhuÅ¡2	ğ’‰¦
53	ğ’ ğ’ˆ
arhuÅ¡5	ğ’€‰ğ’Œ‰
arhuÅ¡6	ğ’€‰ğ’Š©
642	ğ’ ğ’ ğ’ˆ«
643	ğ’ ğ’ ğ’ˆ
640	ğ’ ğ’
aá¸«â‚ƒ	ğ’Œ“
646	ğ’ ğ’ ğ’‹
647	ğ’ ğ’ ğ’Œ
644	ğ’ ğ’ ğ’‰
645	ğ’ ğ’ ğ’Š
biri	ğ’„µ
648	ğ’ ğ’ ğ’
tal3	ğ’€¸
 unken	ğ’Œº
iÃ¡	ğ’Š
ti/te	ğ’‹¾ ğ’‹¼
BÃRA	ğ’ˆ
BANÅ UR	ğ’
TIRUM	ğ’ƒ²ğ’‹¼
Å¡embulug4	ğ’‹ˆ
Å¡embulug3	ğ’‹Œ
SIMUG	ğ’Œ£
(Å¡edu3)	ğ’€†
bir2	ğ’Œ“
immen2	ğ’…˜
bir4	ğ’‚”
bir6	ğ’Š¶
MUÅ %MUÅ 	ğ’ˆ¸
bir8	ğ’€€ğ’‹¤
bir9	ğ’‰ˆ
Ã¨	ğ’Œ“ğ’º
nÃ­q	ğ’ƒ»
gÃ¡ra	ğ’‚¶
{d}nisaba	ğ’€­ ğ’Šºğ’‰€
DALLA	ğ’ˆ¦ğ’„˜ğ’ƒ¼
dili	ğ’€¸
eÅ¡emen3	ğ’‚ ğ’„¾
eÅ¡emen2	ğ’† ğ’‚Šğ’‰ˆğ’²ğ’€­ğ’ˆ¹
kÃ­	ğ’„€
_gidri	ğ’‰º
eÅ¡emen5	ğ’‰
{iri}masz	ğ’Œ· ğ’ˆ¦
kÃ 	ğ’‚µ
kÃ¡	ğ’†
sim2	ğ’‹§
jal2/pisz10	ğ’…… ğ’† ğ’€€
kÃ¹	ğ’†¬
[ku4	ğ’†­
aia2	ğ’€€
á¹£Ãºr	ğ’ˆ²
Å E&Å E	ğ’”µ
szen#	ğ’Š¿
URâ‚‚	ğ’Œ«
_buru14	ğ’‚™
gahalla	ğ’ƒ“
Ãºru	ğ’
dun4	ğ’‚ˆ
dun5	ğ’”
dun3	ğ’‚…
Å¡im2	ğ’‰†
lul{ku6}	ğ’ˆœ ğ’„©
6	ğ’‹
NINNI5	ğ’Œƒ
haÅ¡2	ğ’¨
UDU	ğ’‡»
563	ğ’ ğ’Œ‹ğ’Œ‹ ğ’ˆ
Å UKU	ğ’‰»
KEÅ DA;	ğ’†Ÿ
muhaldim	ğ’ˆ¬
maÅ¡2	ğ’ˆ§
BÃN	ğ’‘
GIBIL;	ğ’‰‹
BÃD	ğ’‰»
DÃ™L	ğ’Š¨
ubiÅ¡aga	ğ’‹±
DÃ™G	ğ’„­
562	ğ’ ğ’Œ‹ğ’Œ‹ ğ’ˆ«
Å¡am2	ğ’‰š
Å¡am3	ğ’‰“
gaesz	ğ’‚µğ’†œ
9 a	ğ’‘† ğ’€€
(Å¡embulug3)	ğ’‹Œ
tibir	ğ’‹³
uru2	ğ’
nu11	ğ’‰¢
PIÅ ;	ğ’„«
nisig	ğ’Š¬
t[al]	ğ’Š‘
ki	ğ’† 
{m}re	ğ’¹ ğ’Š‘
uru7	ğ’Œ²
Å¡et	ğ’‹ƒ
ke	ğ’† 
Å¡er	ğ’‹“
Å¡urâ‚„	ğ’‡³ğ’Š¬
ka	ğ’…—
Å¡en	ğ’Š¿
Ya	ğ’‰¿
Å¡el	ğ’‹»
BALA	ğ’„
du11/dug4	ğ’…— ğ’…—
{na4}ara3	ğ’‰Œğ’Œ“ ğ’„¯
Å¡ed	ğ’‹ƒ
ku	ğ’†ª
nÃ­Ä	ğ’ƒ»
Ê¾u	ğ’€ª
saga11	ğ’†¥
[lugal]	ğ’ˆ—
barag	ğ’ˆ
 jiri3	ğ’„Š
Gir2	ğ’„ˆ
Ê¾e	ğ’€ª
YA	ğ’‰¿
(gaburra)	ğ’ƒ‚
Ê¾a	ğ’€ª
dusi2	ğ’€²ğ’…†ğ’‚ 
Tur	ğ’Œ‰
_ab2	ğ’€–
tugâ‚‚	ğ’Œ†
sÃºm	ğ’®
n[i	ğ’‰Œ
gukkal	ğ’‡»ğ’„¾
Å¡e6	ğ’‰ˆ
_lu2	ğ’‡½
Å¡e4	ğ’ˆ»
Å¡e5	ğ’ğ’ˆ¹ğ’²
Å¡e2	ğ’‹›
Å¡e3	ğ’‚ 
189	ğ’— ğ’‘†
188	ğ’— ğ’
GA@g	ğ’‚¶
irtu	ğ’ƒ®
giÅ¡ta'e	ğ’Ÿ
180	ğ’—
asâ‚‚	ğ’€¾
182	ğ’— ğ’ˆ«
 la	ğ’†·
184	ğ’— ğ’‰
[Å¡]ar	ğ’Š¬
186	ğ’— ğ’‹
lÃ¬b	ğ’Š®
lÃ¬l	ğ’‹™ğ’Œ‹ğ’Œ‹ğ’Œ‹
DÃš	ğ’Œ…
bara2	ğ’ˆ
bara3	ğ’–
ad3	ğ’‡¼
kÃ­d	ğ’‹º
bara7	ğ’‡‹
NAGA	ğ’‰€
bara5	ğ’‡ƒ
bara9	ğ’‡—
Å UDUL;	ğ’‹™
kÃ­n	ğ’„¯
Å UK	ğ’‰»
nag	ğ’…˜
Å¡eg5	ğ’‹
kÃºÅ¡u	ğ’†µ
(silig3)	ğ’‹¸
nab	ğ’€®
nam	ğ’‰†
nan	ğ’‹€
tÃº	ğ’Œ“
tÃ¹	ğ’º
Å¡eg9	ğ’Š¾
nat	ğ’†³
SU	ğ’‹¢
naq	ğ’…˜
nap	ğ’€®
tÃ 	ğ’‹³
Uâ‚„	ğ’Œ“
LAGAR@g	ğ’‡¯
DIÅ 	ğ’¹
Se	ğ’‹›
BUR2	ğ’”
EME	ğ’…´
pur	ğ’“
Å¡ara2	ğ’‡‹
szam3	ğ’‰“
szam2	ğ’‰š
pum	ğ’…¤
pul	ğ’‡§
na]	ğ’ˆ¾
dul	ğ’Œ‹ğ’Œ†
{gesz}kiri6_	ğ’„‘ ğ’Š¬
956	ğ’ ğ’™ ğ’ ğ’‹
na!	ğ’ˆ¾
amâ‚ƒ	ğ’€€ğ’€­
Å¡Ã¹du	ğ’†ƒ
{d}li	ğ’€­ ğ’‡·
nim3	ğ’Œ‹ğ’Œ“
anzu2	ğ’€­ğ’…ğ’ˆª
nisi	ğ’Š¬
á¹£i2	ğ’£
Ã¬r	ğ’€´
na4	ğ’‰Œğ’Œ“
Ã¬l	ğ’€­
3(diÅ¡)	ğ’ˆ
na3	ğ’€
na2	ğ’ˆ¿
gidim	ğ’„‡
nisz	ğ’Œ‹ğ’Œ‹
Å¡ubur	ğ’‹š
nÃ©	ğ’‰Œ
na8	ğ’…˜
pu3	ğ’…¤
pu2	ğ’‡¥
GilgameÅ¡	ğ’„‘ğ’‚†ğ’ˆ¦
Å¡aran	ğ’™
uj3	ğ’Œ¦
Å¡arrum	ğ’ˆ—
szakar	ğ’Š¬
tu	ğ’Œ…
dumu	ğ’Œ‰
_{gesz}gu	ğ’„‘ ğ’„–
SÃ€	ğ’
SÃ	ğ’²
giÅ¡	ğ’„‘
SÃŒ	ğ’‹§
[kur	ğ’†³
szur4{ki}	ğ’‡³ğ’Š¬ ğ’† 
sun2	ğ’„¢
usan3	ğ’‰®
usan2	ğ’„
MEsz	ğ’ˆ¨ğ’Œ
ta	ğ’‹«
sun4	ğ’…¾
568	ğ’ ğ’Œ‹ğ’Œ‹ ğ’
ti	ğ’‹¾
n]u	ğ’‰¡
{anÅ¡e}kunga	ğ’€² ğ’‹™ğ’€¯
EMÃ‰	ğ’Œğ’ˆ¨
duh	ğ’ƒ®
ari2	ğ’…‚
Å¡uba	ğ’ğ’ˆ½
Å¡ud;	ğ’‹¤
dul2	ğ’‡¥
dul3	ğ’Š¨
dul5	ğ’Œ†
dul6	ğ’‡¯
dul7	ğ’Š•
ge6_	ğ’ˆª
bahar4	ğ’‡ğ’‚”
laâ‚‚	ğ’‡²
szabra	ğ’‰ºğ’€ 
lÃ­mmu	ğ’‡¹
zabala2{ki}	ğ’ğ’ˆ¹ğ’€• ğ’† 
1024	ğ’ ğ’› ğ’‰
silaâ‚ƒ	ğ’‹¡
<e2>	ğ’‚
t]Ãº	ğ’Œ“
ildum2	ğ’…†ğ’‰„ğ’
ildum3	ğ’‰„ğ’
t,	á¹­
GÃšR	ğ’ƒµ
dubâ‚‚	ğ’‚€
NUNDUM	ğ’…»
murub2	ğ’Š©ğ’‡¬
ra re ir ru	ğ’Š ğ’Š‘ ğ’…• ğ’Š’
 lugal	ğ’ˆ—
SAÄœ	ğ’Š•
KAÅ 4	ğ’½
akkil	ğ’ƒ°ğ’‹ºğ’‹›
gaÅ¡am	ğ’‰£ğ’ˆ¨ğ’‹³
gaÅ¡an	ğ’ƒ½
r[a	ğ’Š
sangu	ğ’‹ƒ
gu8	ğ’„£
ar(RI)	ğ’Š‘
gu4	ğ’„
gu5	ğ’†ª
gu6	ğ’…˜
gu7	ğ’…¥
gu2	ğ’„˜
gu3	ğ’…—
sanga	ğ’‹ƒ
 22	ğ’Œ‹ğ’Œ‹ ğ’ˆ«
GAL2	ğ’……
ses	ğ’‹€
280	ğ’˜ ğ’
DIR	ğ’‹›ğ’€€
nak	ğ’…˜
_gig_	ğ’ˆªğ’‰­
la[m	ğ’‡´
á¹­u3	ğ’º
BULUG&BULUG	ğ’’
idim	ğ’…‚
DIN	ğ’·
á¹­u4	ğ’Œˆ
mud3	ğ’‰¯
DIB	ğ’³
eridu	ğ’‰£
ÃˆÅ E	ğ’…‚
 arad2	ğ’€µ
aÅ¡nan	ğ’Šºğ’Šºğ’‰ª
NISABA	ğ’Šºğ’‰€
_udu	ğ’‡»
za]	ğ’
LÃM	ğ’‡¹
LÃL	ğ’†¤
banÅ¡ur2	ğ’…ƒ
gur	ğ’„¥
luâ‚‚	ğ’‡½
gul	ğ’„¢
gum	ğ’„£
gun	ğ’„˜ğ’Œ¦
kÃºrun	ğ’·
za_	ğ’
gud	ğ’„
[ul	ğ’ŒŒ
gug	ğ’ğ’„¢
Ã¬Å¡	ğ’Œ
1095	ğ’ ğ’œ ğ’Œ‹ ğ’Š
1094	ğ’ ğ’œ ğ’Œ‹ ğ’‰
1097	ğ’ ğ’œ ğ’Œ‹ ğ’Œ
se3	ğ’‹§
1091	ğ’ ğ’œ ğ’Œ‹ ğ’¹
1090	ğ’ ğ’œ ğ’Œ‹
dur	ğ’„™
subur	ğ’‹š
se9	ğ’ˆ»
RU2	ğ’†•
1099	ğ’ ğ’œ ğ’Œ‹ ğ’‘†
1098	ğ’ ğ’œ ğ’Œ‹ ğ’
á¹­ur	ğ’„™
á¹­up	ğ’¾
tÃºl	ğ’‡¥
naÄ	ğ’…˜
gil	ğ’„ƒ
gim	ğ’¶
gin	ğ’º
(karadin2)	ğ’Š¼
agarin2	ğ’€
gid	ğ’†¤
BARGI	ğ’Œ
sisz	ğ’‹€
gig	ğ’ˆªğ’‰­
NAGA@NAGA	ğ’‰ƒ
giz	ğ’„‘
tÃºm	ğ’º
6 a	ğ’‹ ğ’€€
dub!(MES)	ğ’ˆ©
gir	ğ’„«
gis	ğ’„‘
git	ğ’†¤
sisi	ğ’€²ğ’†³ğ’Š
SAL	ğ’Š©
706	ğ’ ğ’• ğ’ ğ’‹
705	ğ’ ğ’• ğ’ ğ’Š
704	ğ’ ğ’• ğ’ ğ’‰
saá¸«ar	ğ’…–
BÃšN	ğ’…®
701	ğ’ ğ’• ğ’ ğ’¹
700	ğ’ ğ’• ğ’
SAG	ğ’Š•
 sun4	ğ’…¾
a[n	ğ’€­
708	ğ’ ğ’• ğ’ ğ’
nuska	ğ’‰ºğ’Œ†
kikken2	ğ’„¯ğ’„¯
gi_	ğ’„€
Å¡aqa2	ğ’‹
4(ban2)	ğ’‘’
986	ğ’ ğ’š ğ’Œ‹ğ’Œ‹ ğ’‹
Ã­tima	ğ’Œ–
SAR	ğ’Š¬
szukur2	ğ’‰»
GÃD	ğ’
u2#	ğ’Œ‘
lugud2	ğ’†¸
lugud3	ğ’ˆŸ
Å¡ita5	ğ’‹ƒ
erim2	ğ’‰ˆğ’Š’
[re]	ğ’Š‘
{d}sud	ğ’€­ ğ’‹¤
zar	ğ’‡¡
SA4	ğ’„·ğ’ˆ¿
SA5	ğ’‹›ğ’€€
SA6	ğ’Š·
gi3	ğ’•
gi4	ğ’„„
SA2	ğ’²
gi7	ğ’‚ 
DIM	ğ’´
_kur_	ğ’†³
siskur2	ğ’€¬ğ’€¬
[ni	ğ’‰Œ
GARâ‚ƒ	ğ’ƒ¼
uraÅ¡	ğ’…
[na	ğ’ˆ¾
eridug	ğ’‰£
iÅ¡	ğ’…–
garaÅ¡5	ğ’† ğ’†—
garaÅ¡4	ğ’†œğ’‚µ
garaÅ¡3	ğ’‚µğ’†œ
garaÅ¡2	ğ’† ğ’†˜
(Å¡emeÅ¡al)	ğ’‹‘
larsa{ki}	ğ’Œ“ğ’€• ğ’† 
NININDU	ğ’‡…
niÄinâ‚†	ğ’€
739	ğ’ ğ’– ğ’Œ‹ ğ’‘†
291	ğ’˜ ğ’ ğ’¹
PEÅ 4	ğ’Š¯
nab3	ğ’€­ğ’€­
732	ğ’ ğ’– ğ’Œ‹ ğ’ˆ«
733	ğ’ ğ’– ğ’Œ‹ ğ’ˆ
730	ğ’ ğ’– ğ’Œ‹
731	ğ’ ğ’– ğ’Œ‹ ğ’¹
736	ğ’ ğ’– ğ’Œ‹ ğ’‹
737	ğ’ ğ’– ğ’Œ‹ ğ’Œ
734	ğ’ ğ’– ğ’Œ‹ ğ’‰
735	ğ’ ğ’– ğ’Œ‹ ğ’Š
esz4	ğ’¹
Äi6	ğ’ˆª
arina	ğ’ˆ¸ğ’€€ğ’ˆ¾
uku2	ğ’‡³ğ’º
947	ğ’ ğ’™ ğ’ ğ’Œ
uku3	ğ’Œ¦
668	ğ’ ğ’• ğ’
669	ğ’ ğ’• ğ’‘†
946	ğ’ ğ’™ ğ’ ğ’‹
nitalam	ğ’Š©ğ’‘ğ’®
gÃ¹n	ğ’¯
660	ğ’ ğ’•
661	ğ’ ğ’• ğ’¹
gÃ¹b	ğ’†
663	ğ’ ğ’• ğ’ˆ
664	ğ’ ğ’• ğ’‰
habrud	ğ’†¢
666	ğ’ ğ’• ğ’‹
667	ğ’ ğ’• ğ’Œ
maá¸«â‚‚	ğ’€ 
943	ğ’ ğ’™ ğ’ ğ’ˆ
(kisim5)	ğ’†¨
geÅ¡tin	ğ’ƒ¾
UTTU	ğ’‹¸
nir3	ğ’ğ’‰
sipa	ğ’‰ºğ’‡»
(eÅ¡gal)	ğ’€
zah	ğ’‰ˆ
975	ğ’ ğ’š ğ’Œ‹ ğ’Š
sila4	ğ’ƒ¢
akszak{ki}	ğ’Œ” ğ’† 
<á¸«i>	ğ’„­
zal	ğ’‰Œ
a{ki}	ğ’€€ ğ’† 
 MUNUS	ğ’Š©
geÅ¡tug	ğ’‰¿
siszkur	ğ’€¬
aÄarin	ğ’€Œ
[ku3	ğ’†¬
sila	ğ’‹»
igi	ğ’…†
dan3	ğ’ƒ©
dan6	ğ’•
dan4	ğ’ƒ‹
{gisz}gisal	ğ’„‘ ğ’„
KÃD	ğ’‹º
igu	ğ’…†
BÃ€D	ğ’‚¦
asil3	ğ’‚¢
sÃºn	ğ’„¢
innin	ğ’ˆ¹
szik	ğ’‹
 geme2	ğ’Š©ğ’†³
1009	ğ’ ğ’š ğ’ ğ’‘†
MURUBâ‚„	ğ’‰ 
SZA2	ğ’ƒ»
Muh	ğ’Œ‹ğ’…—
1004	ğ’ ğ’š ğ’ ğ’‰
RA	ğ’Š
Ã€	ğ’‰¿
RE	ğ’Š‘
galga	ğ’ƒŒ
szitim	ğ’¶
RI	ğ’Š‘
1002	ğ’ ğ’š ğ’ ğ’ˆ«
703	ğ’ ğ’• ğ’ ğ’ˆ
suá¸«ur	ğ’‹¦
Ã¨rim	ğ’Œ¿
iri{ki}	ğ’Œ· ğ’† 
sil7	ğ’‚£
sil6	ğ’‚¢
RU	ğ’Š’
banda3	ğ’Œ‰
banda2	ğ’‘
aÄ2	ğ’‰˜
dana	ğ’†œğ’
usur	ğ’‡³ğ’Š¬
Ra	ğ’Š
Äir15	ğ’‚ 
Ta3	ğ’‹³
Re	ğ’Š‘
388	ğ’š ğ’Œ‹ğ’Œ‹ ğ’
702	ğ’ ğ’• ğ’ ğ’ˆ«
uia	ğ’Œ‹ğ’Š
asila	ğ’‚°
(hibis2)	ğ’€¨
gurusz	ğ’„¨
AÅ +U	ğ’€¸ğ’Œ‹
Äal2]	ğ’……
ia	ğ’…€
ib	ğ’…
id	ğ’€‰
DUâ‚†	ğ’‡¯
ig	ğ’……
ih	ğ’„´
ii	ğ’…€
ik	ğ’……
il	ğ’…‹
im	ğ’…
in	ğ’…”
973	ğ’ ğ’š ğ’Œ‹ ğ’ˆ
ip	ğ’…
iq	ğ’……
ir	ğ’…•
is	ğ’„‘
it	ğ’€‰
iu	ğ’…€
iw	ğ’‰¿
ix	ğ’‡‰ğ’€€
iz	ğ’„‘
{d}za	ğ’€­ ğ’
[ke4]	ğ’†¤
Isz8	ğ’€¹
UBUR4	ğ’¢
iH	ğ’„´
1042	ğ’ ğ’› ğ’Œ‹ğ’Œ‹ ğ’ˆ«
bargi	ğ’Œ
ÄiÅ¡bun	ğ’† ğ’‰ğ’ƒ»
_ibila_	ğ’Œ‰ğ’‘
gigir3	ğ’‡•
:	ğ’‘±
SILA3	ğ’‹¡
{d}GIÅ 	ğ’€­ ğ’„‘
GUR8	ğ’‹½
itima{ma}	ğ’ƒŸ ğ’ˆ 
i_	ğ’„¿
geÅ¡tu2	ğ’„‘ğ’Œ†ğ’‰¿
KEÅ DA	ğ’†Ÿ
i'	ğ’€ª
 10	ğ’Œ‹
 nu	ğ’‰¡
iÅ¡8	ğ’€¹
i3	ğ’‰Œ
i4	ğ’‰Œğ’Œ“
GU2	ğ’„˜
 niÄ2	ğ’ƒ»
 na	ğ’ˆ¾
 ne	ğ’‰ˆ
gab/duá¸«	ğ’ƒ® ğ’ƒ®
BAN2	ğ’‘
BAN3	ğ’Œ‰
_kaskal_	ğ’†œ
BÃº	ğ’†œ
(aÅ¡)	ğ’€¸
lilâ‚‚	ğ’†¤
{d}Nanna	ğ’€­ ğ’‹€ğ’† 
la6_	ğ’†—
banâ‚ƒ	ğ’Œ‰
LIL5	ğ’‹™ğ’‰ˆ
kud3	ğ’†ª
kud5	ğ’†¯
LIL2	ğ’†¤
kud6	ğ’†‘
[i]	ğ’„¿
Äa2	ğ’‚·
kÃ Å¡	ğ’’
ninna2{muszen}	ğ’‡§ ğ’„·
had2	ğ’Œ“
aÄâ‚‚	ğ’‰˜
t,ar	ğ’‹»
881	ğ’ ğ’˜ ğ’ ğ’¹
me6	ğ’€
sa6	ğ’Š·
TAM	ğ’Œ“
TAL	ğ’Š‘
1086	ğ’ ğ’œ ğ’‹
1087	ğ’ ğ’œ ğ’Œ
1084	ğ’ ğ’œ ğ’‰
tum	ğ’Œˆ
1082	ğ’ ğ’œ ğ’ˆ«
1083	ğ’ ğ’œ ğ’ˆ
1080	ğ’ ğ’œ
1081	ğ’ ğ’œ ğ’¹
[it	ğ’€‰
1088	ğ’ ğ’œ ğ’
1089	ğ’ ğ’œ ğ’‘†
[im	ğ’…
[in	ğ’…”
sa2	ğ’²
á¸«Ãºb	ğ’„¸
á¸«Ãºl	ğ’„¾
uá¸«	ğ’„´
t[i]	ğ’‹¾
[gaba	ğ’ƒ®
kat3	ğ’†‘
(karadin3)	ğ’Š½
GÃ€KKUL	ğ’Œ‹ğ’´
_ka2_	ğ’†
KANKAL	ğ’† ğ’†—
Ã¬limmu	ğ’‘‡
 d	ğ’€­
ra#	ğ’Š
mÃ©gidda	ğ’‹°ğ’†²
TA@g	ğ’‹¯
PIÅ 	ğ’„«
i2	ğ’Š
meâ‚ƒ	ğ’€
kissa	ğ’† ğ’‹€ğ’†•
 i	ğ’„¿
TA*	ğ’‹«
BAD5	ğ’…†
Äisal	ğ’„
{d}tu	ğ’€­ ğ’Œ…
nin9	ğ’Š©ğ’†ª
se26	ğ’€€ğ’ˆ¹ğ’²
se25	ğ’ˆ¹ğ’²
se24	ğ’€€ğ’ˆ¹
tu15/im	ğ’… ğ’…
uÊ¾	ğ’€ª
i7	ğ’€€ğ’‡‰
EGIR	ğ’‚•
suh5	ğ’†ª
at et it tu	ğ’€œ ğ’€‰ ğ’€‰ ğ’Œ…
285	ğ’˜ ğ’ ğ’Š
suh3	ğ’„—
Å IBIR	ğ’Œ‹ğ’‚™
NAGA@180	ğ’‰
dat	ğ’‹º
Ã¡[Å¡	ğ’€¾
mit	ğ’
mir	ğ’‚‡
mis	ğ’ˆ©
umusz	ğ’Œ†
gahili	ğ’ƒ”
tara	ğ’‹»
ie	ğ’…€
mid	ğ’…‚
1	ğ’¹
min	ğ’ˆ«
mil	ğ’…–
mim	ğ’Š©
UH3	ğ’†µ
UH2	ğ’Œ”
BÃL	ğ’‰‹
ka10	ğ’ˆœğ’€€
sÃ¹r	ğ’„®
{d}iszkur	ğ’€­ ğ’…
5(ban2)	ğ’‘”
hub2	ğ’„¸
kiÄ2	ğ’†¥
1076	ğ’ ğ’› ğ’ ğ’‹
ma_	ğ’ˆ 
ga ge gi gu	ğ’‚µ ğ’„€ ğ’„€ ğ’„–
sÃ¹h	ğ’„—
TILLAâ‚‚	ğ’€­ğ’€¸ğ’€­
mi4	ğ’ƒ
mi5	ğ’‰¿
mi2	ğ’Š©
Aga	ğ’‚‡
akkil2	ğ’€œğ’†¤
2/3	ğ’‘›
KARAÅ 	ğ’† ğ’†˜
Ãºsan	ğ’„
KISZ	ğ’†§
RAM;	ğ’‰˜
Ã¹	ğ’…‡
tar2	ğ’¯
tar3	ğ’°
Å¡ab	ğ’‰ºğ’…
_uzu_	ğ’œ
dak3	ğ’‰Œğ’Œ“
Å¡ad	ğ’†³
GIÅ IMMAR	ğ’Š·
Å¡ak	ğ’Š•
Å¡ah	ğ’‹š
 1	ğ’¹
LÃŒL	ğ’‹™ğ’Œ‹ğ’Œ‹ğ’Œ‹
á¹£]e	ğ’¢
Å¡al	ğ’Š©
Å¡am	ğ’Œ‘
Å¡ar	ğ’Š¬
Å¡as	ğ’‹€
Å¡ap	ğ’‰ºğ’…
piÅ¡;	ğ’„«
ri(á¸ªU)	ğ’„·
_ugu	ğ’Œ‹ğ’…—
Å¡at	ğ’†³
d]an	ğ’†—
90	ğ’• ğ’Œ
91	ğ’• ğ’Œ ğ’¹
92	ğ’• ğ’Œ ğ’ˆ«
93	ğ’• ğ’Œ ğ’ˆ
94	ğ’• ğ’Œ ğ’‰
sÃ 	ğ’
96	ğ’• ğ’Œ ğ’‹
838	ğ’ ğ’— ğ’ ğ’
98	ğ’• ğ’Œ ğ’
99	ğ’• ğ’Œ ğ’‘†
147	ğ’– ğ’Œ‹ğ’Œ‹ ğ’Œ
[Å¡]a	ğ’Š­
141	ğ’– ğ’Œ‹ğ’Œ‹ ğ’¹
140	ğ’– ğ’Œ‹ğ’Œ‹
143	ğ’– ğ’Œ‹ğ’Œ‹ ğ’ˆ
142	ğ’– ğ’Œ‹ğ’Œ‹ ğ’ˆ«
gada	ğ’ƒ°
sipad	ğ’‰ºğ’‡»
PÃšÅ 	ğ’‰½ğ’„¬
MUNU6	ğ’Šºğ’‘
Å¡a!	ğ’Š­
agar4	ğ’…Š
URU3	ğ’Œ¶
ÃŒ	ğ’‰Œ
Å¡a2	ğ’ƒ»
Å¡a3	ğ’Š®
_ug3	ğ’Œ¦
GUN3	ğ’¯
Ã©rim	ğ’‰ˆğ’Š’
Å¡a4	ğ’º
TÃá¸ª	ğ’ƒ®
Å¡inig	ğ’‹’
sÃ©	ğ’£
U+12038	ğ’Œ‹ğ’¤ğ’Ÿğ’Œğ’ ğ’¤ğ’Ÿğ’Œğ’
Å¡Ã¬ta	ğ’‹¥
kÃ¡d	ğ’†
Å¡uÅ¡ur	ğ’€¼
kÃ¡b	ğ’…˜
aÅ¡3	ğ’‹
UTU	ğ’Œ“
kÃ¡n	ğ’ƒ·
741	ğ’ ğ’– ğ’Œ‹ğ’Œ‹ ğ’¹
szer7	ğ’‰ª
kÃ¡t	ğ’†
NIMGIR	ğ’‚‡
r[aÅ¡	ğ’†œ
AÅ 4	ğ’‹°ğ’‹°ğ’‹°
kÃ¡r	ğ’ƒ¸
t,u3	ğ’º
AÅ 9	ğ’‘€
aÅ¡7	ğ’‹“
NE	ğ’‰ˆ
NA	ğ’ˆ¾
aÅ¡4	ğ’‹°ğ’‹°ğ’‹°
{d}NIN	ğ’€­ ğ’Š©ğ’Œ†
TAR	ğ’‹»
ulÃ¹	ğ’‡
tig3	ğ’‚€
744	ğ’ ğ’– ğ’Œ‹ğ’Œ‹ ğ’‰
NI	ğ’‰Œ
tig4	ğ’‹¾
NU	ğ’‰¡
SIPAD	ğ’‰ºğ’‡»
gesz	ğ’„‘
gur_	ğ’„¥
Å ÃŒTA	ğ’‹¥
aka3	ğ’‹ƒ
GAR	ğ’ƒ»
(gukin)	ğ’‡
Na	ğ’ˆ¾
gid2]	ğ’
qan	ğ’ƒ¶
egi2	ğ’Š©ğ’‚ 
{tug2}aktum	ğ’Œ† ğ’€€ğ’‹¢
Nu	ğ’‰¡
ama5	ğ’ƒ£
GAB	ğ’ƒ®
BURANUN	ğ’Œ“ğ’„’ğ’‰£
GAD	ğ’ƒ°
QÃ­	ğ’† 
miÅ¡	ğ’ˆ©
babila#	ğ’…—ğ’€­
sip	ğ’ˆ¨
ildag2	ğ’„Ÿ
sÃ¹	ğ’‹¤
GAL	ğ’ƒ²
GAM	ğ’ƒµ
GAN	ğ’ƒ¶
457	ğ’› ğ’Œ ğ’Œ
GA2	ğ’‚·
muÅ¡3	ğ’ˆ¹
m[i]r	ğ’‚‡
barâ‚‡	ğ’‰ˆ
Å AB	ğ’‰ºğ’…
umbin	ğ’Œ¢
nigin	ğ’†¸ğ’†¸
(samag2)	ğ’Œ 
â¸¢tilâ¸£	ğ’Œ€
Å¡eg14	ğ’…ğ’€€ğ’€­
t,a	ğ’•
t,e	ğ’²
Å¡eg12	ğ’‹
szeg12	ğ’‹
á¸ªÃšB	ğ’„¸
INANNA	ğ’ˆ¹
lilis	ğ’€—
ESZ	ğ’Œ
TAB	ğ’‹°
qa3	ğ’…—
GIR6	ğ’¼
Äidlam2	ğ’‘ğ’®
Äidlam3	ğ’‘ğ’Š©ğ’®
liliz	ğ’€—
GIR2	ğ’„ˆ
[li	ğ’‡·
amat	ğ’Š©ğ’†³
gur2	ğ’ƒµ
[lu	ğ’‡»
gur7	ğ’„¦
[á¹£]u	ğ’®
amar	ğ’€«
gur4	ğ’†¸
zid2	ğ’¥
TAG	ğ’‹³
KÃ€Å 	ğ’’
[szu]	ğ’‹—
GISAL	ğ’„
DARA4	ğ’±
NÃ	ğ’ˆ¿
NÃ	ğ’‰
ir11	ğ’€µ
unken	ğ’Œº
459	ğ’› ğ’Œ ğ’‘†
QA	ğ’‹¡
ra3	ğ’Œ“
per	ğ’Œ“
ra5	ğ’
ra4	ğ’‹¥
NÃš	ğ’ˆ¿
[xx]	ğ’Ššğ’ƒ®
650	ğ’ ğ’
Å¡uÅ¡5	ğ’‡Ÿ
Å¡uÅ¡6	ğ’‡ 
 2	ğ’ˆ«
Å¡uruppag	ğ’‹¢ğ’†³ğ’Š’
iÅ¡ib	ğ’ˆ¨
 3	ğ’ˆ
Å¡aá¸«2	ğ’‚„
{dug}szakir3	ğ’‚ ğ’Œ¼
 eÅ¡3	ğ’€Š
Qa	ğ’‹¡
dam_	ğ’®
arkabâ‚‚	ğ’€¶
654	ğ’ ğ’ ğ’‰
dara4	ğ’±
rah	ğ’ˆ›
ul3	ğ’„’
ul2	ğ’‰¡
egir	ğ’‚•
ul4	ğ’„‰
dara2	ğ’…
dara3	ğ’°
rab	ğ’Š
rad	ğ’‹¥
rag	ğ’Š©
659	ğ’ ğ’ ğ’‘†
1085	ğ’ ğ’œ ğ’Š
eden	ğ’‚”
raq	ğ’Š©
t,Ã¡	ğ’‹«
ras	ğ’†œ
buâ‚â‚†(NI)	ğ’‰Œ
ra2	ğ’º
{ÄeÅ¡}aga	ğ’„‘ ğ’‚‡
 ÄiÅ¡	ğ’„‘
1107	ğ’ ğ’œ ğ’Œ‹ğ’Œ‹ ğ’Œ
hasz	ğ’‹»
MURU9	ğ’…ğ’‚‚
ib2	ğ’Œˆ
1106	ğ’ ğ’œ ğ’Œ‹ğ’Œ‹ ğ’‹
1105	ğ’ ğ’œ ğ’Œ‹ğ’Œ‹ ğ’Š
36000	ğ’¬
UTUA	ğ’­
Ã¨Å¡e	ğ’…‚
lukur	ğ’Š©ğ’ˆ¨
ra]	ğ’Š
GUB	ğ’º
lagaÅ¡[	ğ’‰¢ğ’“ğ’†·
Å¡Ã¬r	ğ’‚¡
996	ğ’ ğ’š ğ’Œ ğ’‹
NIGâ‚‚	ğ’ƒ»
(karadin)	ğ’Œ„
1102	ğ’ ğ’œ ğ’Œ‹ğ’Œ‹ ğ’ˆ«
Ã©gi	ğ’Š©ğ’‚ 
995	ğ’ ğ’š ğ’Œ ğ’Š
NUSKA	ğ’‰ºğ’Œ†
UGU	ğ’Œ‹ğ’…—
q]iÅ¡	ğ’†§
tuhul	ğ’‰„ğ’
[e?]	ğ’‚Š
ÃˆÅ 	ğ’€Š
á¹­ir	ğ’‹›ğ’€€
buru14	ğ’‚™
t]ah	ğ’ˆ­
ha	ğ’„©
TÃ­	ğ’„­
eren	ğ’‚
ia]	ğ’…€
8	ğ’
GIR4	ğ’Œ‹ğ’€œ
(arad2)	ğ’€µ
bu	ğ’
1(ban2)	ğ’‘
 KA	ğ’…—
[bar	ğ’‡
TÃ¬	ğ’´
ba	ğ’€
ia8	ğ’‰¿
ia9	ğ’€¼ğ’‹°
be	ğ’
{kuÅ¡}ala	ğ’‹¢ ğ’Œ·
elamkuÅ¡	ğ’‡Œ
bi	ğ’‰
ia3	ğ’‰Œ
(gumgum)	ğ’ˆ
nigru	ğ’…š
ia7	ğ’‹°ğ’‹°ğ’€¸
ia5	ğ’ˆ¬
gÃ­t	ğ’
muÅ¡	ğ’ˆ²
á¹­i3	ğ’‹¾
5(u)?	ğ’
zi	ğ’£
sumun	ğ’Œ€
szagina	ğ’„Šğ’€´
enim	ğ’…—
ni9	ğ’Œ‹ğ’Œ“ğ’†¤
UG3	ğ’Œ¦
deâ‚‚	ğ’Œ¤
sumur	ğ’Š¨
Pa	ğ’‰º
_nim	ğ’‰
(esag)	ğ’€ˆ
u4	ğ’Œ“
u5	ğ’„·ğ’‹›
u6	ğ’…†ğ’‚
u7	ğ’† ğ’ˆ«
u2	ğ’Œ‘
u3	ğ’…‡
zadim	ğ’ˆ¯
je26	ğ’‚·
á¹­i	ğ’²
(gahalla)	ğ’ƒ“
_gesztin_	ğ’ƒ¾
gin3]	ğ’†³
biluda	ğ’‰ºğ’€­
(usan2)	ğ’„
u'	ğ’€ª
Nam2	ğ’‰‡
Å UN;	ğ’Š¿
ebih2	ğ’‚ ğ’ˆ¤
adamin	ğ’ˆ“
alammuÅ¡	ğ’‹­
si4	ğ’‹œ
te!	ğ’‹¼
lÃ¡l	ğ’‡³
kÃ s	ğ’„¤
kir4	ğ’…—
dilib3	ğ’Š 
dilib2	ğ’†‚
te4	ğ’‰ˆ
te3	ğ’‰€
te2	ğ’„­
kÃ l	ğ’†•
te9	ğ’‹¾
te8	ğ’€‰
gi16	ğ’„ƒ
PÃš	ğ’‡¥
PÃ™	ğ’…¤
uw	ğ’‰¿
up	ğ’Œ’
uq	ğ’ŠŒ
ur	ğ’Œ¨
us	ğ’Š»
bÃ¹	ğ’…¤
Äar	ğ’ƒ»
á¸«ur	ğ’„¯
á¸«us	ğ’ˆ
ux	ğ’‹ ğ’€¸
uz	ğ’Š»
ud	ğ’Œ“
gur3	ğ’…
ug	ğ’ŠŒ
á¸«ul	ğ’…†ğ’Œ¨
á¸«um	ğ’ˆ
ub	ğ’Œ’
U	ğ’Œ‹
ul	ğ’ŒŒ
um	ğ’Œ
á¸«ub	ğ’„½
kat2	ğ’†
uh	ğ’„´
bÃ¬	ğ’‰¿
uk	ğ’ŠŒ
83	ğ’• ğ’Œ‹ğ’Œ‹ ğ’ˆ
686	ğ’ ğ’• ğ’Œ‹ğ’Œ‹ ğ’‹
81	ğ’• ğ’Œ‹ğ’Œ‹ ğ’¹
80	ğ’• ğ’Œ‹ğ’Œ‹
87	ğ’• ğ’Œ‹ğ’Œ‹ ğ’Œ
86	ğ’• ğ’Œ‹ğ’Œ‹ ğ’‹
85	ğ’• ğ’Œ‹ğ’Œ‹ ğ’Š
84	ğ’• ğ’Œ‹ğ’Œ‹ ğ’‰
ginâ‚ƒ	ğ’†³
ten	ğ’‹¼
89	ğ’• ğ’Œ‹ğ’Œ‹ ğ’‘†
tel	ğ’Œ€
Å UÅ ANA	ğ’‘š
ganba	ğ’† ğ’‡´
zah2	ğ’„©ğ’€€
SZIR	ğ’‹“
ter	ğ’Œ
tep	ğ’³
duru5	ğ’€€
APIN	ğ’€³
MUNSUB;	ğ’ˆ°
mas,	ğ’ˆ¦
ni4	ğ’Š©ğ’Œ†
jir2	ğ’„ˆ
681	ğ’ ğ’• ğ’Œ‹ğ’Œ‹ ğ’¹
her	ğ’†Ÿ
uszur	ğ’‡³ğ’Š¬
lil5	ğ’‹™ğ’‰ˆ
ze4	ğ’€“
huluh	ğ’ˆ›
taszkarin	ğ’Œ†
SAG5	ğ’‹ƒ
ze2	ğ’¢
mu#	ğ’ˆ¬
_1(bur3)	ğ’Œ‹
eme	ğ’…´
mu2	ğ’Š¬
mu3	ğ’…¡
ku15	ğ’„
436	ğ’› ğ’Œ‹ ğ’‹
688	ğ’ ğ’• ğ’Œ‹ğ’Œ‹ ğ’
mu4	ğ’Œ†
mu5	ğ’‰Œ
ereÅ¡	ğ’Š©ğ’Œ†
suá¸«uÅ¡	ğ’¼
ku13	ğ’„£
ER2	ğ’€€ğ’…†
giskim	ğ’…†ğ’¾
kislah2	ğ’†£
ZIKURA	ğ’†œğ’‹
ug7	ğ’Œ€
{d}NUSKA	ğ’€­ ğ’‰ºğ’Œ†
 kiÅ¡	ğ’†§
giszgal	ğ’‡
_dam	ğ’®
uszu3	ğ’Œ
isz11	ğ’‡µ
isz10	ğ’‘
mu_	ğ’ˆ¬
zer	ğ’†°
710	ğ’ ğ’• ğ’
711	ğ’ ğ’• ğ’ ğ’¹
712	ğ’ ğ’• ğ’ ğ’ˆ«
713	ğ’ ğ’• ğ’ ğ’ˆ
714	ğ’ ğ’• ğ’ ğ’‰
715	ğ’ ğ’• ğ’ ğ’Š
mud	ğ’„·ğ’„­
{d}iÅ¡kur	ğ’€­ ğ’…
718	ğ’ ğ’• ğ’ ğ’
_lugal_	ğ’ˆ—
muh	ğ’Œ‹ğ’…—
mun	ğ’µ
437	ğ’› ğ’Œ‹ ğ’Œ
mul	ğ’€¯
mur	ğ’„¯
mus	ğ’ˆ²
muq	ğ’ˆ®
mut	ğ’„·ğ’„­
digir	ğ’€­
431	ğ’› ğ’Œ‹ ğ’¹
_igi	ğ’…†
kuÅ¡7	ğ’…–
kuÅ¡2	ğ’Š¨
kuÅ¡3	ğ’Œ‘
NÃG	ğ’ƒ»
nita	ğ’‘
kiriâ‚ƒ	ğ’…—
sir2	ğ’
432	ğ’› ğ’Œ‹ ğ’ˆ«
kiriâ‚†	ğ’Š¬
433	ğ’› ğ’Œ‹ ğ’ˆ
ba be bi bu	ğ’€ ğ’ ğ’‰ ğ’
1/2(disz)	ğ’ˆ¦
ni3	ğ’ƒ»
URI3	ğ’Œ¶
UN	ğ’Œ¦
á¸«uÄ	ğ’‚ 
ASARI	ğ’‚
esag	ğ’€ˆ
(tibir5)	ğ’‹µ
LA	ğ’†·
taá¸«	ğ’ˆ­
ni2	ğ’‰
SÃG+AÅ 	ğ’‹ğ’€¾
zik;	ğ’¨
 silim	ğ’²
[zu]	ğ’ª
_udu_	ğ’‡»
kuÅ¡u	ğ’Œ‹ğ’ŠŠ
t,i	ğ’²
TUN3	ğ’‚…
SI@g	ğ’‹œ
GÃ‰ME	ğ’Š©ğ’†³
nit,	ğ’‘
isimud	ğ’‰½ğ’…Š
uÅ¡	ğ’‘
kam2	ğ’†š
á¸«uÅ¡	ğ’„­ğ’„Š
IGÃŒ	ğ’† ğ’Š•
gÃ¹ruÅ¡	ğ’€
lÃ­á¸«	ğ’‚Ÿ
ABGAL	ğ’‰£ğ’ˆ¨
nansze	ğ’€
 za3	ğ’ 
tilla2	ğ’€­ğ’€¸ğ’€­
gesztug3	ğ’„‘ğ’‰¿ğ’Œ†
se27	ğ’ˆ¹
gi	ğ’„€
ugra	ğ’‡¨
eÅ¡e2	ğ’‚ 
[si	ğ’‹›
MESZ	ğ’ˆ¨ğ’Œ
ugula	ğ’‰º
ad it ut	ğ’€œ ğ’€‰ ğ’Œ“
gur8	ğ’‹½
4270	ğ’Š¹ ğ’ ğ’• ğ’Œ‹
294	ğ’˜ ğ’ ğ’‰
169	ğ’– ğ’ ğ’‘†
168	ğ’– ğ’ ğ’
ÄÃ¨Å¡	ğ’‘
297	ğ’˜ ğ’ ğ’Œ
_ur	ğ’Œ¨
u2 za	ğ’Œ‘ ğ’
163	ğ’– ğ’ ğ’ˆ
162	ğ’– ğ’ ğ’ˆ«
_szah2_	ğ’‚„
296	ğ’˜ ğ’ ğ’‹
167	ğ’– ğ’ ğ’Œ
166	ğ’– ğ’ ğ’‹
165	ğ’– ğ’ ğ’Š
164	ğ’– ğ’ ğ’‰
libisz	ğ’€š
298	ğ’˜ ğ’ ğ’
_um	ğ’Œ
Å¡egâ‚â‚‚	ğ’‹
Å¡e20	ğ’…†
giggi	ğ’ˆª
(silig2)	ğ’‹¹
_i7_	ğ’€€ğ’‡‰
Ã‰N	ğ’‹™ğ’€­
GIRI16	ğ’„Œ
NU11	ğ’‰¢
aÄ	ğ’€
Um	ğ’Œ
(Å¡edur)	ğ’‡¤
hasz2	ğ’¨
wa we wi wu	ğ’‰¿ ğ’‰¿ ğ’‰¿ ğ’‰¿
hasz4	ğ’®
Un	ğ’Œ¦
szita2	ğ’‚·ğ’„‘
_u4	ğ’Œ“
Å AM4	ğ’‰†
nindu	ğ’‡…
Å AM2	ğ’‰š
tuk]ul	ğ’†ª
ASZA5	ğ’ƒ·
_u8	ğ’‡‡
ninda	ğ’ƒ»
Å IR@t	ğ’‹”
Uk	ğ’ŠŒ
a2!	ğ’€‰
zuâ‚‚	ğ’…—
kusz3	ğ’Œ‘
nij2	ğ’ƒ»
hu	ğ’„·
min_	ğ’ˆ«
981	ğ’ ğ’š ğ’Œ‹ğ’Œ‹ ğ’¹
980	ğ’ ğ’š ğ’Œ‹ğ’Œ‹
983	ğ’ ğ’š ğ’Œ‹ğ’Œ‹ ğ’ˆ
982	ğ’ ğ’š ğ’Œ‹ğ’Œ‹ ğ’ˆ«
Äe6	ğ’ˆª
1115	ğ’ ğ’œ ğ’Œ ğ’Š
1116	ğ’ ğ’œ ğ’Œ ğ’‹
1117	ğ’ ğ’œ ğ’Œ ğ’Œ
989	ğ’ ğ’š ğ’Œ‹ğ’Œ‹ ğ’‘†
988	ğ’ ğ’š ğ’Œ‹ğ’Œ‹ ğ’
[s]ag	ğ’Š•
[ma	ğ’ˆ 
usz8	ğ’€³
am em imi um	ğ’„  ğ’… ğ’… ğ’Œ
usz3	ğ’ƒ£
usz2	ğ’Œ€
asza5	ğ’ƒ·
mÃºru	ğ’‰ 
(gagirsu)	ğ’ƒ
limmu2	ğ’‡¹
á¹£a	ğ’
[mu	ğ’ˆ¬
limmu5	ğ’‰
limmu4	ğ’½
bÃ¬Å¡eba	ğ’„¡
garin	ğ’‡‘
garim	ğ’‡‘
Ãˆ	ğ’Œ“ğ’º
NUN@t	ğ’‰©
dimgul	ğ’ˆ£ğ’ˆ®
mÃºÅ¡	ğ’ˆ½
[la]	ğ’†·
suhub4	ğ’‹—ğ’²ğ’Œ‹ğ’Œ‹ğ’Œ‹
BULUG	ğ’‘
Äen	ğ’º
GIÅ @t	ğ’„•
AGAM	ğ’€‚
egir2	ğ’‚ 
3600	ğ’Š¹
dEn	ğ’·
(edakua)	ğ’‚¸
Ã‰GI	ğ’Š©ğ’‚ 
min3	ğ’Œ‹ğ’Œ‹
isz8	ğ’€¹
nita2_	ğ’€´
isz6	ğ’„‘
ZA@t	ğ’
isz4	ğ’¹
isz3	ğ’Œ
isz2	ğ’†œ
GURUN	ğ’„§
sur10	ğ’ˆ£ğ’…Š
{d}szakkan2	ğ’€­ ğ’„Š
min#	ğ’ˆ«
ararma2	ğ’Œ“ğ’€Š
Å¡Ã kir	ğ’Œ¼
KUSZ	ğ’‹¢
Ar	ğ’…ˆ
il]	ğ’…‹
Silim	ğ’²
MUG	ğ’ˆ®
MUD	ğ’„·ğ’„­
nen	ğ’Š©ğ’Œ†
GEME2	ğ’Š©ğ’†³
MUN	ğ’µ
ned	ğ’‘
MUL	ğ’€¯
ERIN	ğ’‚
ERIM	ğ’‚Ÿ
a]	ğ’€€
8 i	ğ’ ğ’„¿
a_	ğ’€€
nes	ğ’Œ‹ğ’Œ‹
ner	ğ’‰ª
ah	ğ’„´
ai	ğ’€€ğ’€€
un]	ğ’Œ¦
ak	ğ’€
al	ğ’€ 
am	ğ’„ 
an	ğ’€­
252	ğ’˜ ğ’Œ‹ ğ’ˆ«
ilu	ğ’€­
ab	ğ’€Š
Sag	ğ’Š•
259	ğ’˜ ğ’Œ‹ ğ’‘†
258	ğ’˜ ğ’Œ‹ ğ’
zabar_	ğ’Œ“ğ’…—ğ’‡
ag	ğ’€
ax	ğ’•
az	ğ’Š
gilin	ğ’‰¾
eren2/erin2	ğ’‚Ÿ ğ’‚Ÿ
dingir	ğ’€­
ap	ğ’€Š
aq	ğ’€
ar	ğ’…ˆ
PÃD	ğ’
ila	ğ’€­
au	ğ’€€ğ’‰ºğ’„ğ’‰»ğ’‹›ğ’€€
abrig2	ğ’€–ğ’‰£ğ’ˆ¨ğ’º
aw	ğ’‰¿
eger	ğ’‚•
IGI@g	ğ’…Š
UR%UR	ğ’Œ©
[ina	ğ’€¸
á¸«i	ğ’„­
398	ğ’š ğ’Œ ğ’
_szu_	ğ’‹—
á¸«e	ğ’„­
un3	ğ’‚¦
8 1	ğ’ ğ’¹
u]á¹­	ğ’Œ“
36	ğ’Œ ğ’‹
37	ğ’Œ ğ’Œ
34	ğ’Œ ğ’‰
35	ğ’Œ ğ’Š
32	ğ’Œ ğ’ˆ«
33	ğ’Œ ğ’ˆ
30	ğ’Œ
31	ğ’Œ ğ’¹
mÃºnÅ¡ub	ğ’‹ ğ’‡´ğ’‹¦
ne3	ğ’ŠŠ
ne2	ğ’‰Œ
38	ğ’Œ ğ’
39	ğ’Œ ğ’‘†
gumgum	ğ’ˆ
[da	ğ’•
il8	ğ’…Œ
il5	ğ’‚–
a!	ğ’€€
a#	ğ’€€
ablal3	ğ’‡¦
il3	ğ’€­
il2	ğ’…
BAá¸ªARâ‚‚	ğ’ƒ
ARÃD	ğ’€µ
a2	ğ’€‰
a3	ğ’‰¿
a4	ğ’€€ğ’€­
ÃšRU	ğ’
890	ğ’ ğ’˜ ğ’
Sa3	ğ’
ina]	ğ’€¸
_du10	ğ’„­
eri/iri	ğ’Œ· ğ’Œ·
ka13	ğ’„°
la2_	ğ’‡²
pÃ r	ğ’–
la2]	ğ’‡²
NA4	ğ’‰Œğ’Œ“
peÅ¡;	ğ’„«
NA3	ğ’€
NA2	ğ’ˆ¿
iku2	ğ’‚½
peÅ¡4	ğ’Š¯
pÃ d	ğ’…†ğ’Š’
peÅ¡2	ğ’‰¾
szumun	ğ’Œ€
{lu2}ha	ğ’‡½ ğ’„©
par2	ğ’‡
par3	ğ’–
szar2	ğ’Š¹
szar3	ğ’ˆ—
szar4	ğ’Œ‹ğ’Œ‹
par4	ğ’‰Œğ’„‘
par5	ğ’‚Ÿ
IÅ KUR	ğ’…
{m}á¸«um	ğ’¹ ğ’ˆ
{kus}a	ğ’‹¢ ğ’€€
tu9	ğ’Œ†
ÄeÅ¡	ğ’„‘
ellag2	ğ’„µ
 BIR	ğ’„µ
Qu2	ğ’†ª
SUá¸ªUÅ 	ğ’¼
NIG2	ğ’ƒ»
anÅ¡e	ğ’€²
SISKUR	ğ’€¬
(elamkuÅ¡3)	ğ’‡ˆ
uzug4	ğ’Œ‘ğ’†³ğ’‰Œğ’Œ‡ğ’† 
NAG	ğ’…˜
kisig2	ğ’‚«
KURUN	ğ’‰ğ’·
NAB	ğ’€®
NAM	ğ’‰†
 Å¡u	ğ’‹—
_ninda	ğ’ƒ»
ensi3	ğ’‚š
NAR	ğ’ˆœ
bat{ki}	ğ’ ğ’† 
<it>	ğ’€‰
{kusz}hal	ğ’‹¢ ğ’„¬
adamen	ğ’ˆ“
didli	ğ’€¸ğ’€¸
Uâ‚‚	ğ’Œ‘
dan	ğ’†—
si11	ğ’‹
kuÅ¡	ğ’‹¢
Å¡eÅ¡	ğ’‹€
KISIM5	ğ’†¨
{iri}uri5{ki}	ğ’Œ· ğ’‹€ğ’€Š ğ’† 
ÄeÅ¡pa	ğ’Š’
szud	ğ’‹¤
umah	ğ’‡¦
Ma2	ğ’ˆ£
zikura	ğ’†œğ’‹
uman	ğ’„´
ilimmu	ğ’‘†
lip	ğ’ˆœ
á¸ªUL4	ğ’…†ğ’Œª
KÃ€D	ğ’†‘
Å¡ah2	ğ’‚„
DIMGUL	ğ’ˆ£ğ’ˆ®
[d]u	ğ’º
SÃšN	ğ’„¢
{gesz}ig	ğ’„‘ ğ’……
ummu3	ğ’€€ğ’‚”ğ’‡²
pÃ¡t	ğ’
pÃ¡r	ğ’‡
kuâ‚ƒ	ğ’†¬
{d}ama	ğ’€­ ğ’‚¼
_he2	ğ’ƒ¶
LÃá¸ªTAN	ğ’‰¶
bulug	ğ’‘
Å¡e!	ğ’Šº
{anÅ¡e}si2	ğ’€² ğ’£
maá¸«	ğ’ˆ¤
GAN2	ğ’ƒ·
ri(á¸ªU)uruda	ğ’„·
158	ğ’– ğ’Œ ğ’
159	ğ’– ğ’Œ ğ’‘†
156	ğ’– ğ’Œ ğ’‹
157	ğ’– ğ’Œ ğ’Œ
154	ğ’– ğ’Œ ğ’‰
155	ğ’– ğ’Œ ğ’Š
152	ğ’– ğ’Œ ğ’ˆ«
153	ğ’– ğ’Œ ğ’ˆ
150	ğ’– ğ’Œ
151	ğ’– ğ’Œ ğ’¹
rak	ğ’Š©
nenni	ğ’‡§ğ’‡§
urim5	ğ’‹€ğ’€Š
tasz	ğ’Œ¨
num2	ğ’ˆ
(iku2)	ğ’‚½
DÃšBUR	ğ’„¶
ELLAT	ğ’†œğ’†³
 nitah	ğ’‘
(meze)	ğ’€™
mÃ¹Å¡	ğ’ˆ¹
MAÅ 2	ğ’ˆ§
AD4	ğ’
Ã­r	ğ’€€ğ’…†
Ã­l	ğ’…
BÃ™LUG	ğ’‰½ğ’‰½
ra{ki}	ğ’Š ğ’† 
{d}Å¡ul	ğ’€­ ğ’‚„
Ã­d	ğ’€€ğ’‡‰
kurum6	ğ’‰»
(dinig2)	ğ’ˆ‹
Ã­a	ğ’Š
Ã­b	ğ’Œˆ
984	ğ’ ğ’š ğ’Œ‹ğ’Œ‹ ğ’‰
a12	ğ’Œ“
AÅ DAR;	ğ’Œ‹ğ’¯
banda3_	ğ’Œ‰
ram	ğ’‰˜
szinig	ğ’‹’
gukin	ğ’‡
nibru{ki}	ğ’‚—ğ’†¤ ğ’† 
b[i]	ğ’‰
{zid2}ba	ğ’¥ ğ’€
á¹£Ã©	ğ’£
buruâ‚„	ğ’‰¢ğ’“
mÃ©nbulug	ğ’’
Ã¬ti	ğ’†œğ’Œš
SAGÅ U	ğ’Œ‹ğ’Š•
á¸«eâ‚‚	ğ’ƒ¶
1120	ğ’ ğ’œ ğ’
szubtum6	ğ’†
gij4	ğ’‚†
638	ğ’ ğ’Œ ğ’
Å¡agina	ğ’„Šğ’€´
tun3	ğ’‚…
arad/Ã¬r	ğ’€´ ğ’€´
qir	ğ’„«
qis	ğ’†§
qip	ğ’„’
e5	ğ’Š©ğ’Œ†
qit	ğ’†¤
ur2#	ğ’Œ«
372	ğ’š ğ’Œ‹ ğ’ˆ«
biâ‚‚	ğ’‰ˆ
kÃºÅ¡	ğ’Š¨
qil	ğ’†¸
qim	ğ’¶
{d}ma	ğ’€­ ğ’ˆ 
qid	ğ’†¤
371	ğ’š ğ’Œ‹ ğ’¹
[di]n	ğ’·
kur	ğ’†³
kut	ğ’‹»
nÃºmun	ğ’¤ğ’†¸
saman4	ğ’Œ‹ğ’ƒ¶
kuk	ğ’†¬
kul	ğ’†°
kum	ğ’„£
kun	ğ’†²
880	ğ’ ğ’˜ ğ’
gizzal2	ğ’„‘ğ’Œ†ğ’‰¿ğ’‰¢ğ’‹¡
kud	ğ’‹»
kug	ğ’†¬
{kuÅ¡}ummud	ğ’‹¢ ğ’€€ğ’‚”ğ’‡²
GUR11	ğ’‚µ
GUR10	ğ’†¥
GUR17	ğ’„•
(lugud3)	ğ’ˆŸ
Å¡urim	ğ’‡‡
<nÃ©>	ğ’‰Œ
kid7	ğ’…
kid3	ğ’€
kid2	ğ’‹º
Å¡Ã¡ra	ğ’‡‹
ESZ6	ğ’€¸ğ’€¸ğ’€¸
ku8	ğ’„–
ku9	ğ’†°
bur12	ğ’
J	ÅŠ
ku2	ğ’…¥
ku3	ğ’†¬
ku4	ğ’†­
ku5	ğ’‹»
ku6	ğ’„©
ku7	ğ’†¯
uÄ3	ğ’Œ¦
LAL2	ğ’‡³
tiâ‚ˆ	ğ’€‰
KÃD	ğ’†
 kurun	ğ’‰ğ’·
UÅ 11	ğ’…œ
gazi	ğ’“Š
AKa	ğ’€
TI@t	ğ’‹¿
szu2	ğ’‹™
ar!(RI)	ğ’Š‘
aratta	ğ’‡¶
ENME	ğ’‚š
Å¡aq	ğ’Š•
ÄÃ©Å¡bu	ğ’‹—ğ’‰½ğ’‰½
Äiri2	ğ’„ˆ
ÃšSSU	ğ’‹°ğ’‹°ğ’‹°ğ’‹°
men4	ğ’‡™
maÅ¡kim2	ğ’‰ºğ’¼
mi3	ğ’ˆ¨
um2	ğ’Œ“
mÃ¹d	ğ’‰¯
 u2	ğ’Œ‘
 u3	ğ’…‡
_erin2_	ğ’‚Ÿ
414	ğ’š ğ’ ğ’‰
adab{ki}	ğ’Œ“ğ’‰£ ğ’† 
632	ğ’ ğ’Œ ğ’ˆ«
21	ğ’Œ‹ğ’Œ‹ ğ’¹
20	ğ’Œ‹ğ’Œ‹
23	ğ’Œ‹ğ’Œ‹ ğ’ˆ
22	ğ’Œ‹ğ’Œ‹ ğ’ˆ«
25	ğ’Œ‹ğ’Œ‹ ğ’Š
qul2	ğ’„¢
KÃR	ğ’ƒ¸
26	ğ’Œ‹ğ’Œ‹ ğ’‹
29	ğ’Œ‹ğ’Œ‹ ğ’‘†
28	ğ’Œ‹ğ’Œ‹ ğ’
giÅ¡kim;	ğ’…†ğ’¾
Ã­Å¡	ğ’†œ
KINGUSILA	ğ’‘œ
zimbir{ki}	ğ’Œ“ğ’„’ğ’‰£ ğ’† 
{ÄiÅ¡}tir	ğ’„‘ ğ’Œ
KIR7	ğ’‰‘
KIR6	ğ’€˜
{iri}kisz{ki}	ğ’Œ· ğ’†§ ğ’† 
suku6	ğ’ˆ¹
anÅ E	ğ’€²
DU8;	ğ’ƒ®
bi#?	ğ’‰
dingir_	ğ’€­
 ur	ğ’Œ¨
umu	ğ’Œ
UB:SAG	ğ’Œ’ ğ’Š•
LILIZ	ğ’€—
ibila2	ğ’Œ‰ğ’€´
 ud	ğ’Œ“
EREN	ğ’‚
da13	ğ’‹º
az2	ğ’€¾
da10	ğ’„­
149	ğ’– ğ’Œ‹ğ’Œ‹ ğ’‘†
148	ğ’– ğ’Œ‹ğ’Œ‹ ğ’
630	ğ’ ğ’Œ
TIDNUM	ğ’Š
tah	ğ’ˆ­
lÃ¹gud	ğ’ˆŸ
kÃºr	ğ’‰½
97	ğ’• ğ’Œ ğ’Œ
887	ğ’ ğ’˜ ğ’ ğ’Œ
iku	ğ’ƒ·
145	ğ’– ğ’Œ‹ğ’Œ‹ ğ’Š
kindagal	ğ’ƒ³
aÊ¾	ğ’€ª
144	ğ’– ğ’Œ‹ğ’Œ‹ ğ’‰
kÃºm	ğ’‰ˆ
qiÅ¡	ğ’†§
aradâ‚‚	ğ’€µ
â¸¢maá¸«â¸£	ğ’ˆ¤
146	ğ’– ğ’Œ‹ğ’Œ‹ ğ’‹
636	ğ’ ğ’Œ ğ’‹
Å¡A	ğ’Š­
ZA	ğ’
NUN:EN	ğ’‰£ ğ’‚—
ta te ti tu	ğ’‹« ğ’‹¼ ğ’‹¾ ğ’Œ…
sÃ¬la	ğ’‹¡
Å¡ita3	ğ’‹¥
igira2	ğ’† ğ’Š•ğ’Š©
pisan3	ğ’‹„
DARâ‚ƒ	ğ’°
ha7	ğ’‚µ
ha6	ğ’„«
ha5	ğ’Œ“
ha4	ğ’„­
ha3	ğ’Œ‹
ha2	ğ’„­ğ’€€
eá¹£	ğ’„‘
eá¹­	ğ’€‰
Å¡e	ğ’Šº
MUNÅ UB	ğ’ˆ°
ha8	ğ’‚·ğ’„‘
kesz3	ğ’‹™ğ’€­ğ’„²
GIÅ 	ğ’„‘
nug2	ğ’‹Š
ha+	ğ’„©
Å¡u	ğ’‹—
be5	ğ’†ª
sag12	ğ’…Š
2(eÅ¡e3)	ğ’‘™
GAL:TUR3	ğ’ƒ² ğ’‰£ğ’‡¬
_lukur	ğ’Š©ğ’ˆ¨
426	ğ’› ğ’‹
427	ğ’› ğ’Œ
(Å¡uÅ¡5)	ğ’‡Ÿ
425	ğ’› ğ’Š
MÃˆ	ğ’€
423	ğ’› ğ’ˆ
420	ğ’›
421	ğ’› ğ’¹
keÅ¡â‚‚	ğ’†Ÿ
DALLA;	ğ’ˆ¦ğ’„˜ğ’ƒ¼
MÃ	ğ’ˆ£
428	ğ’› ğ’
429	ğ’› ğ’‘†
hat	ğ’‰º
has	ğ’‹»
har	ğ’„¯
MÃº	ğ’Š¬
uzu2	ğ’¬
DULâ‚ƒ	ğ’Š¨
zu	ğ’ª
haz	ğ’‹»
(erim4)	ğ’ƒ«
eá¸«	ğ’„´
ará¸«uÅ¡	ğ’ƒ£
had	ğ’‰º
hab	ğ’†¸
za	ğ’
aÅ¡9	ğ’‘€
hal	ğ’„¬
ze	ğ’£
zig3	ğ’£
zig2	ğ’‹
eren2	ğ’‚Ÿ
816	ğ’ ğ’— ğ’Œ ğ’‹
sumun2	ğ’„¢
enkar	ğ’‚™
1040	ğ’ ğ’› ğ’Œ‹ğ’Œ‹
am3#	ğ’€€ğ’€­
NENNI	ğ’‡§ğ’‡§
814	ğ’ ğ’— ğ’Œ ğ’‰
unugi	ğ’€
(samag)	ğ’Œ
1046	ğ’ ğ’› ğ’Œ‹ğ’Œ‹ ğ’‹
_ki_	ğ’† 
1047	ğ’ ğ’› ğ’Œ‹ğ’Œ‹ ğ’Œ
Å¡Ã¨	ğ’‚ 
Å¡Ã©	ğ’‹›
Å¡Ã¬	ğ’‹
811	ğ’ ğ’— ğ’Œ ğ’¹
urdu	ğ’€´
m[eÅ¡]	ğ’ˆ¨ğ’Œ
Å¡aru	ğ’„¶
Å¡Ã¡	ğ’ƒ»
810	ğ’ ğ’— ğ’Œ
ÄœEÅ 	ğ’„‘
3(disz)	ğ’ˆ
raÅ¡	ğ’†œ
Å¡Ãº	ğ’‹™
(gigir3)	ğ’‡•
(ARAD)	ğ’€´
iszkur	ğ’…
immen	ğ’†‰
 e2	ğ’‚
sirara6	ğ’Œ“ğ’ˆ£ğ’€ğ’† ğ’‹³
sÃ¹á¸«	ğ’„—
Å¡ara	ğ’ˆ
man	ğ’Œ‹ğ’Œ‹
á¸«ar	ğ’„¯
ZI&ZI	ğ’¤
Å¡eÄ6	ğ’‰ˆ
MU	ğ’ˆ¬
 igi	ğ’…†
mal	ğ’‚·
TUR3	ğ’‰£ğ’‡¬
URU5	ğ’‹½
KUÅ 	ğ’‹¢
ME	ğ’ˆ¨
818	ğ’ ğ’— ğ’Œ ğ’
esag2	ğ’ƒ¥
MA	ğ’ˆ 
Ã¹ssu	ğ’‘…
246	ğ’˜ ğ’‹
247	ğ’˜ ğ’Œ
244	ğ’˜ ğ’‰
245	ğ’˜ ğ’Š
ÃLIMMU	ğ’‹°ğ’‹°ğ’‹°ğ’‹°ğ’€¸
243	ğ’˜ ğ’ˆ
Å¡ita4	ğ’Œ‹ğ’†¤
241	ğ’˜ ğ’¹
badâ‚ƒ	ğ’‚¦
_numun_	ğ’†°
3 27	ğ’ˆ ğ’Œ‹ğ’Œ‹ ğ’Œ
 nam	ğ’‰†
248	ğ’˜ ğ’
249	ğ’˜ ğ’‘†
zÃ©	ğ’¢
war	ğ’‡
zÃ­	ğ’¢
zÃ¬	ğ’¥
zÃ¡	ğ’‰Œğ’Œ“
zÃ 	ğ’ 
biz2	ğ’„
Ma	ğ’ˆ 
{urud}alal	ğ’ ğ’‹„
UL4	ğ’„‰
(tar)	ğ’‹»
nammu	ğ’‡‰
{urud}alan	ğ’ ğ’€©
á¸«a	ğ’„©
namma	ğ’‡‰
(Å¡erimsur)	ğ’‡œ
taq2	ğ’–
nun	ğ’‰£
(Å¡aqa2)	ğ’‹
SÃ™R	ğ’„®
uâ‚ƒ	ğ’…‡
i10	ğ’Œ“ğ’º
i14	ğ’ˆ¬
i15	ğ’‚Š
Å EG9	ğ’Š¾
Å EG8	ğ’‹™ğ’‰€
[ina]	ğ’€¸
lu7	ğ’‡
mur10	ğ’Œ†
lu5	ğ’ˆœ
lu4	ğ’ˆ
lu3	ğ’ˆ–
lu2	ğ’‡½
{disz}szub	ğ’¹ ğ’Š’
amalug	ğ’‚¼ğ’ˆœ
inana	ğ’ˆ¹
dip	ğ’³
{d}Nin	ğ’€­ ğ’Š©ğ’Œ†
eÅ¡gal	ğ’€
<<u>>	ğ’Œ‹
AÅ GAB	ğ’€¿
557	ğ’ ğ’Œ‹ ğ’Œ
eÅ¡gar	ğ’€¾ğ’ƒ¼
Å¡a[r	ğ’Š¬
IMIN	ğ’…“
GUD	ğ’„
Ã¹ri	ğ’Œ¶
lum	ğ’ˆ
miá¹­	ğ’
Di	ğ’²
luh	ğ’ˆ›
lug	ğ’‡»
DAá¸ª	ğ’ˆ­
_du3_	ğ’†•
lud	ğ’‚
 dam	ğ’®
lub	ğ’ˆœ
Äanun	ğ’ƒ 
KAM2	ğ’†š
KAM3	ğ’†’
haÅ¡	ğ’‹»
 tug2	ğ’Œ†
lut	ğ’‚
Å¡ud3	ğ’†ƒ
sabad2	ğ’‚¿
sabad3	ğ’ƒ–
qat	ğ’‹—
nibru	ğ’‚—ğ’†¤
kunin3	ğ’‡
KU2	ğ’…¥
KU3	ğ’†¬
KU4	ğ’†­
anzud2{muÅ¡en}	ğ’€­ğ’…ğ’ˆª ğ’„·
KU6	ğ’„©
KU7	ğ’†¯
enten	ğ’‰‰
tisz2	ğ’Œ¨
iÊ¾	ğ’€ª
rat	ğ’‹¥
dÃºbur	ğ’„¶
Å¡uk	ğ’‰»
zaq	ğ’ 
Äidru	ğ’‰º
108000	ğ’®
AGA	ğ’‚‡
aÅ¡2	ğ’€¾
na/jesz	ğ’ˆ¾ ğ’„‘
101	ğ’• ğ’ ğ’¹
100	ğ’• ğ’
103	ğ’• ğ’ ğ’ˆ
102	ğ’• ğ’ ğ’ˆ«
105	ğ’• ğ’ ğ’Š
104	ğ’• ğ’ ğ’‰
107	ğ’• ğ’ ğ’Œ
106	ğ’• ğ’ ğ’‹
109	ğ’• ğ’ ğ’‘†
108	ğ’• ğ’ ğ’
zak	ğ’ 
did	ğ’…
t]i	ğ’‹¾
inim	ğ’…—
ZUBUD	ğ’„ª
Å¡i	ğ’…†
[pe]	ğ’‰¿
kum3	ğ’‚¬
ni10	ğ’†¸
SUMUN	ğ’Œ€
kub4	ğ’†¤
gisz3	ğ’‘
nud	ğ’ˆ¿
Å¡a Å¡e Å¡i Å¡u	ğ’Š­ ğ’Šº ğ’…† ğ’‹—
619	ğ’ ğ’Œ‹ ğ’‘†
[Å¡a]ra	ğ’ˆ
13 1	ğ’Œ‹ ğ’ˆ ğ’¹
za3	ğ’ 
za2	ğ’‰Œğ’Œ“
Ãº?	ğ’Œ‘
Ã€M	ğ’€€ğ’€­
KUR	ğ’†³
naj	ğ’…˜
es,3	ğ’€Š
Ã€D	ğ’‡¼
nimgir	ğ’‚‡
[b]i	ğ’‰
KUM	ğ’„£
KUN	ğ’†²
[b]e	ğ’
ÄœE6	ğ’ˆª
KUB	ğ’º
KUD	ğ’‹»
tuâ‚„	ğ’Œˆ
KUG	ğ’†¬
491	ğ’œ ğ’Œ‹ ğ’¹
LÃš	ğ’‡½
(I)	ğ’„¿
b]Ã©	ğ’‰
Ug5	ğ’‚¦
danna_	ğ’†œğ’
si]	ğ’‹›
e11	ğ’‡¯ğ’º
PAP	ğ’‰½
 diÄir	ğ’€­
LÃ	ğ’‡²
sid	ğ’ˆ»
Å¡[Ã¡	ğ’ƒ»
sig	ğ’‹
IB2	ğ’Œˆ
sib	ğ’ˆ¨
sil	ğ’‹»
sim	ğ’‹†
sin	ğ’Œ
t,u4	ğ’Œˆ
sik	ğ’‹
kasz4	ğ’½
t]e	ğ’‹¼
siq	ğ’‹
sir	ğ’‹¤
sis	ğ’‹€
{gesz}tukul	ğ’„‘ ğ’†ª
Å¡[Ãº	ğ’‹™
jissu	ğ’„‘ğ’ˆª
ganzir	ğ’…†ğ’†³ğ’
k[a	ğ’…—
Å Ãˆ	ğ’‚ 
<gaba	ğ’ƒ®
LÃL	ğ’‡³
Å Ã	ğ’ƒ»
Å Ã€	ğ’Š®
eki	ğ’‚Š
992	ğ’ ğ’š ğ’Œ ğ’ˆ«
993	ğ’ ğ’š ğ’Œ ğ’ˆ
990	ğ’ ğ’š ğ’Œ
 den	ğ’·
1103	ğ’ ğ’œ ğ’Œ‹ğ’Œ‹ ğ’ˆ
997	ğ’ ğ’š ğ’Œ ğ’Œ
1101	ğ’ ğ’œ ğ’Œ‹ğ’Œ‹ ğ’¹
1100	ğ’ ğ’œ ğ’Œ‹ğ’Œ‹
998	ğ’ ğ’š ğ’Œ ğ’
999	ğ’ ğ’š ğ’Œ ğ’‘†
1109	ğ’ ğ’œ ğ’Œ‹ğ’Œ‹ ğ’‘†
1108	ğ’ ğ’œ ğ’Œ‹ğ’Œ‹ ğ’
ulu	ğ’ŒŒ
l[i!]	ğ’‡·
PAD	ğ’‰»
asar	ğ’‚
ÄÃ©Å¡	ğ’•
t,ur	ğ’„™
t,up	ğ’¾
PAB	ğ’‰½
lahtan	ğ’‰´
t,uh	ğ’ƒ®
si7	ğ’Œ¤
t,ul	ğ’‡¥
si3	ğ’‹§
t,ub	ğ’¾
al el il ul	ğ’€  ğ’‚– ğ’…‹ ğ’ŒŒ
gigir	ğ’‡€
kuszu	ğ’Œ‹ğ’ŠŠ
KÃšR	ğ’‰½
LU	ğ’‡»
SUDâ‚‚	ğ’‹¥
á¸ªAL	ğ’„¬
MASZ	ğ’ˆ¦
434	ğ’› ğ’Œ‹ ğ’‰
2(ban2)	ğ’‘
di8	ğ’Œ¤
b]i	ğ’‰
430	ğ’› ğ’Œ‹
LI	ğ’‡·
LAá¸ª5	ğ’ºğ’º
Å¡uÅ¡ana	ğ’‘š
zuen	ğ’‚—ğ’ª
439	ğ’› ğ’Œ‹ ğ’‘†
438	ğ’› ğ’Œ‹ ğ’
tibira	ğ’¾ğ’‰„
Å¡[a	ğ’Š­
{munus}hi	ğ’Š© ğ’„­
GAl	ğ’ƒ²
Lu	ğ’‡»
{gesz}gag	ğ’„‘ ğ’†•
á¸ªAR	ğ’„¯
Å¡a	ğ’Š­
di2	ğ’„­
ap ep ip up	ğ’€Š ğ’… ğ’… ğ’Œ’
AKKIL	ğ’ƒ°ğ’‹ºğ’‹›
kusz2	ğ’Š¨
MIR	ğ’‚‡
ensi2	ğ’‰ºğ’‹¼ğ’‹›
di7	ğ’‰ˆ
tibir5	ğ’‹µ
kusz8	ğ’„¾
US	ğ’Š»
tibir2	ğ’‹·
Å E	ğ’Šº
kin2	ğ’„¯
GAS	ğ’„¤
SED	ğ’ˆ¹ğ’²
LAá¸ªTAN	ğ’‰´
Å¡Ã­ta	ğ’‚·ğ’„‘
MIN	ğ’ˆ«
Å U	ğ’‹—
ma5	ğ’…¡
e	ğ’‚Š
879	ğ’ ğ’˜ ğ’Œ ğ’‘†
tiÅ¡	ğ’¹
nÃ­nda	ğ’‰’
kisim5	ğ’†¨
KESZ2	ğ’†Ÿ
GIL2	ğ’†¸
MUÅ â‚ƒ	ğ’ˆ¹
naga	ğ’‰€
GURUSZ	ğ’„¨
kig2	ğ’†¥
GAZ	ğ’„¤
ZIZNA	ğ’ŒŠ
613	ğ’ ğ’Œ‹ ğ’ˆ
SZITIM	ğ’¶
GIR3+2	ğ’„Šğ’ˆ« ğ’ˆ«
si2	ğ’£
bet	ğ’‚
duá¸«;	ğ’ƒ®
{d}1(u)	ğ’€­ ğ’Œ‹
qat3	ğ’ƒ°
ber	ğ’„µ
im2	ğ’½
GALAM	ğ’ƒ´
eÅ¡tub	ğ’„
kuszu2	ğ’†µ
[:]	ğ’‘±
bel	ğ’‰ˆ
ennegi	ğ’…
Äiri3	ğ’„Š
Å ÃTA	ğ’‚·ğ’„‘
13 1:57	ğ’Œ‹ ğ’ˆ ğ’¹ ğ’ğ’Œ
at,	ğ’€œ
szimaszki	ğ’‡»ğ’‹¢
â€™u	ğ’€ª
ÃTI	ğ’Œ›
m[e]d	ğ’
GAG	ğ’†•
i[t?	ğ’€‰
SANGA~b	ğ’‹ƒ
gÃ kkul	ğ’Œ‹ğ’´
riÅ¡	ğ’Š•
â€™i	ğ’€ª
at6	ğ’‡¿
_lugal	ğ’ˆ—
at2	ğ’„‰
ALIMa	ğ’„‹
GIÅ KIM;	ğ’…†ğ’¾
MÃ	ğ’Š©
uÅ¡bar	ğ’Œ°
Å A3	ğ’Š®
PÃ€R	ğ’–
til	ğ’Œ€
 ba	ğ’€
Å¡anabi	ğ’‘›
adab#{ki}	ğ’Œ“ğ’‰£ ğ’† 
AGRIG	ğ’…†ğ’¾
imi	ğ’…
URBINGU	ğ’Œ©
PÃ€D	ğ’…†ğ’Š’
uttu	ğ’‹¸
 ki	ğ’† 
taq3	ğ’‰Œğ’Œ“
_egir_	ğ’‚•
bÃº	ğ’†œ
nanÅ¡e	ğ’€
 ka	ğ’…—
keâ‚„	ğ’†¤
Å AM	ğ’Œ‘
606	ğ’ ğ’‹
BIL2	ğ’‰‹
(elamkuÅ¡2)	ğ’‡–
tid	ğ’…
KAL%KAL	ğ’†™
(Å¡embulug4)	ğ’‹ˆ
RAM	ğ’‰˜
Ãºh	ğ’Œ”
megida(LAK20)zabar	ğ’“ª
dugâ‚„	ğ’…—
ti!	ğ’‹¾
RAB	ğ’Š
RAD	ğ’‹¥
mussa/munussa	ğ’Š©ğ’‘ğ’² ğ’Š©ğ’‘ğ’²
{lu2}i3	ğ’‡½ ğ’‰Œ
ti8	ğ’€‰
kasz2	ğ’†œ
ti3	ğ’´
ti2	ğ’„­
laá¸«6	ğ’º
ti5	ğ’
ti4	ğ’²
Aá¸ª	ğ’„´
engar	ğ’€³
Å¡e3]	ğ’‚ 
guru7	ğ’„¦
Adab	ğ’Œ“ğ’‰£
NANNA	ğ’‹€ğ’† 
t,u	ğ’‚…
keÅ¡2	ğ’†Ÿ
keÅ¡3	ğ’‹™ğ’€­ğ’„²
ti]	ğ’‹¾
 Å¡ar2	ğ’Š¹
RA2	ğ’º
tiq	ğ’„˜
á¸«ir	ğ’†Ÿ
tik	ğ’„˜
mat	ğ’†³
tin	ğ’·
tim	ğ’´
halbi2	ğ’ğ’ˆ¹ğ’²
utuki	ğ’™
alam	ğ’€©
alal	ğ’‹„
Ugu	ğ’Œ‹ğ’…—
179	ğ’– ğ’ ğ’‘†
174	ğ’– ğ’ ğ’‰
gala	ğ’‘ğ’†ª
176	ğ’– ğ’ ğ’‹
177	ğ’– ğ’ ğ’Œ
170	ğ’– ğ’
be3	ğ’‰Œ
172	ğ’– ğ’ ğ’ˆ«
173	ğ’– ğ’ ğ’ˆ
Å A	ğ’Š­
tir	ğ’Œ
_{lu2}hun	ğ’‡½ ğ’‚ 
178	ğ’– ğ’ ğ’
maÅ¡gi;	ğ’Œ
526	ğ’œ ğ’ ğ’‹
